filename,content,unit_type,char_count,word_count,start_pos,end_pos
info_cubo_acuerdos_bilaterales_v11.md,"=== MEDIDAS ===

** Plazas ofertadas para alumnos **
Número total de plazas de movilidad de entrada y/o de salida que se ofertan, en virtud de programas de intercambio, para realizar una estancia temporal en una universidad (distinta de aquélla en la que se cursan estudios), en el marco de acuerdos bilaterales suscritos por Unizar y registrados en SIGMA.

>Nota: El intercambio debe ir asociado a algún tipo de reconocimiento académico.

** Plazas asignadas a los alumnos OUT **
Número total de plazas de movilidad que han sido asignadas a estudiantes de Unizar para realizar estancias otras Universidades, correspondientes a los acuerdos bilaterales registrados en SIGMA.

>Nota: sólo se contabilizan plazas de programas de intercambio que tienen informados en SIGMA todos los
datos correspondientes a la solicitud del alumno, a la asignación de plaza y al contrato de estudios. Por tant se muestran datos correspondientes a los programas ERASMUS y SICUE desde el curso 2012/13, de Movilid UE-Suiza desde el curso 2014/15, y de UZ/NOA y Movilidad Iberoamérica desde el curso 2016/17.

** Plazas ofertadas a docentes **
Número total de plazas de movilidad que se ofertan al personal docente de entrada y/o salida, en virtud de programas de intercambio suscritos por Unizar, para realizar una estancia temporal en una universidad (distinta de aquélla en que imparten docencia).

** Número de acuerdos bilaterales **
Número total de acuerdos de movilidad con otras universidades, registrados en SIGMA, en el marco de los programas de intercambio suscritos por Unizar.",section,1568,281,0,1568
info_cubo_acuerdos_bilaterales_v11.md,=== DIMENSIONES ===,section,20,3,1569,1589
info_cubo_acuerdos_bilaterales_v11.md,"## DIMENSION: CURSO ACADÉMICO ##

Notas generales:
- Clasifica los datos en función del curso académico para el que tiene vigencia el acuerdo bilateral.

>Nota: El primer curso académico del que constan datos es el 2012/13.",section,224,44,1590,1814
info_cubo_acuerdos_bilaterales_v11.md,"## DIMENSION: Centro Responsable ##

Notas generales:
- Permite clasificar los datos en función del centro de Unizar responsable del acuerdo de movilidad.

>Nota: Para los acuerdos que no tienen centro responsable, se indica 021-Ámbito General.",section,245,45,1815,2060
info_cubo_acuerdos_bilaterales_v11.md,"## DIMENSION: Colectivo ##

Notas generales:
- Permite clasificar los datos en función del colectivo al que está destinada la movilidad en el acuerdo bilatera

>Valores posibles: Alumnos, Docentes.",section,198,37,2061,2259
info_cubo_acuerdos_bilaterales_v11.md,"## DIMENSION: Entrada o Salida (IN/OUT) ##

Notas generales:
- Permite clasificar los datos en función de si el acuerdo bilateral oferta plazas de movilidad de entrada (IN) o salida (OUT).",section,189,42,2260,2449
info_cubo_acuerdos_bilaterales_v11.md,"## DIMENSION: Fecha de actualización ##

Notas generales:
- Indica la fecha de la última recarga de datos. Habitualmente se realiza el domingo anterior a la fecha de consulta de datos.",section,185,37,2450,2635
info_cubo_acuerdos_bilaterales_v11.md,"## DIMENSION: Idioma ##

Atributos:
• Nivel Principal:
Permite clasificar los datos en función del idioma principal contemplado en el acuerdo bilateral.

>Nota: se indica “no informado” cuando no hay un idioma registrado en el acuerdo.

• Nivel Secundario:
Permite clasificar los datos en función del idioma secundario contemplado en el acuerdo bilateral.

>Nota: se indica “no informado” cuando no hay un idioma registrado en el acuerdo.",section,439,85,2636,3075
info_cubo_acuerdos_bilaterales_v11.md,"## DIMENSION: Meses ofertados por plaza ##

Notas generales:
- Permite clasificar los datos en función de la duración de la estancia en meses contemplada en el acuerdo.

>Nota: las estancias correspondientes a las plazas asignadas a docentes no tienen informada duración (se
indica “No informado”).",section,299,58,3076,3375
info_cubo_acuerdos_bilaterales_v11.md,"## DIMENSION: Nivel de estudios ##

Notas generales:
- Permite identificar el nivel formativo de los estudiantes establecido en el acuerdo bilateral.

>Valores posibles: Undergraduate, Undergraduate/Postgraduate, Undergraduate/Doctoral,
Undergraduate/Postgraduate/Doctoral, Postgraduate, Postgraduate/Doctoral, Doctoral.

>Nota: Para los datos correspondientes a las plazas asignadas a docentes se muestra el valor “(Docentes)”.",section,429,68,3376,3805
info_cubo_acuerdos_bilaterales_v11.md,"## DIMENSION: País de la Universidad del Acuerdo ##

Notas generales:
- Permite clasificar los datos en función del país al que pertenece la universidad con la que se firma el acuerd bilateral.",section,194,38,3806,4000
info_cubo_acuerdos_bilaterales_v11.md,"## DIMENSION: Programa de Movilidad ##

Notas generales:
- Permite clasificar los datos en función del programa de movilidad en virtud del cual se establece el acuerdo bilateral.",section,179,33,4001,4180
info_cubo_acuerdos_bilaterales_v11.md,"## DIMENSION: Universidad del Acuerdo ##

Notas generales:
- Permite clasificar los datos en función de la universidad con la que se firma el acuerdo bilateral.",section,161,31,4181,4342
info_cubo_acuerdos_bilaterales_v11.md,"## DIMENSION: Universidad del Acuerdo UNITA (S/N) ##

Notas generales:
- Permite clasificar los datos en función de si la universidad con la que se firma el acuerdo bilateral pertenece alianza de universidades europeas UNITA (S) o no (N).

>El primer curso académico en que están registradas universidades UNITA es 2020/21.",section,325,64,4343,4668
info_cubo_acuerdos_bilaterales_v11.md,=== MEDIDAS ===,paragraph,15,3,0,15
info_cubo_acuerdos_bilaterales_v11.md,"** Plazas ofertadas para alumnos **
Número total de plazas de movilidad de entrada y/o de salida que se ofertan, en virtud de programas de intercambio, para realizar una estancia temporal en una universidad (distinta de aquélla en la que se cursan estudios), en el marco de acuerdos bilaterales suscritos por Unizar y registrados en SIGMA.",paragraph,339,64,17,356
info_cubo_acuerdos_bilaterales_v11.md,>Nota: El intercambio debe ir asociado a algún tipo de reconocimiento académico.,paragraph,80,15,358,438
info_cubo_acuerdos_bilaterales_v11.md,"** Plazas asignadas a los alumnos OUT **
Número total de plazas de movilidad que han sido asignadas a estudiantes de Unizar para realizar estancias otras Universidades, correspondientes a los acuerdos bilaterales registrados en SIGMA.",paragraph,234,39,440,674
info_cubo_acuerdos_bilaterales_v11.md,">Nota: sólo se contabilizan plazas de programas de intercambio que tienen informados en SIGMA todos los
datos correspondientes a la solicitud del alumno, a la asignación de plaza y al contrato de estudios. Por tant se muestran datos correspondientes a los programas ERASMUS y SICUE desde el curso 2012/13, de Movilid UE-Suiza desde el curso 2014/15, y de UZ/NOA y Movilidad Iberoamérica desde el curso 2016/17.",paragraph,410,73,676,1086
info_cubo_acuerdos_bilaterales_v11.md,"** Plazas ofertadas a docentes **
Número total de plazas de movilidad que se ofertan al personal docente de entrada y/o salida, en virtud de programas de intercambio suscritos por Unizar, para realizar una estancia temporal en una universidad (distinta de aquélla en que imparten docencia).",paragraph,290,53,1088,1378
info_cubo_acuerdos_bilaterales_v11.md,"** Número de acuerdos bilaterales **
Número total de acuerdos de movilidad con otras universidades, registrados en SIGMA, en el marco de los programas de intercambio suscritos por Unizar.",paragraph,187,34,1380,1567
info_cubo_acuerdos_bilaterales_v11.md,=== DIMENSIONES ===,paragraph,19,3,1569,1588
info_cubo_acuerdos_bilaterales_v11.md,## DIMENSION: CURSO ACADÉMICO ##,paragraph,32,8,1590,1622
info_cubo_acuerdos_bilaterales_v11.md,"Notas generales:
- Clasifica los datos en función del curso académico para el que tiene vigencia el acuerdo bilateral.",paragraph,118,21,1624,1742
info_cubo_acuerdos_bilaterales_v11.md,>Nota: El primer curso académico del que constan datos es el 2012/13.,paragraph,69,15,1744,1813
info_cubo_acuerdos_bilaterales_v11.md,## DIMENSION: Centro Responsable ##,paragraph,35,8,1815,1850
info_cubo_acuerdos_bilaterales_v11.md,"Notas generales:
- Permite clasificar los datos en función del centro de Unizar responsable del acuerdo de movilidad.",paragraph,117,20,1852,1969
info_cubo_acuerdos_bilaterales_v11.md,">Nota: Para los acuerdos que no tienen centro responsable, se indica 021-Ámbito General.",paragraph,88,17,1971,2059
info_cubo_acuerdos_bilaterales_v11.md,## DIMENSION: Colectivo ##,paragraph,26,7,2061,2087
info_cubo_acuerdos_bilaterales_v11.md,"Notas generales:
- Permite clasificar los datos en función del colectivo al que está destinada la movilidad en el acuerdo bilatera",paragraph,130,22,2089,2219
info_cubo_acuerdos_bilaterales_v11.md,">Valores posibles: Alumnos, Docentes.",paragraph,37,8,2221,2258
info_cubo_acuerdos_bilaterales_v11.md,## DIMENSION: Entrada o Salida (IN/OUT) ##,paragraph,42,12,2260,2302
info_cubo_acuerdos_bilaterales_v11.md,"Notas generales:
- Permite clasificar los datos en función de si el acuerdo bilateral oferta plazas de movilidad de entrada (IN) o salida (OUT).",paragraph,144,30,2304,2448
info_cubo_acuerdos_bilaterales_v11.md,## DIMENSION: Fecha de actualización ##,paragraph,39,9,2450,2489
info_cubo_acuerdos_bilaterales_v11.md,"Notas generales:
- Indica la fecha de la última recarga de datos. Habitualmente se realiza el domingo anterior a la fecha de consulta de datos.",paragraph,143,28,2491,2634
info_cubo_acuerdos_bilaterales_v11.md,## DIMENSION: Idioma ##,paragraph,23,7,2636,2659
info_cubo_acuerdos_bilaterales_v11.md,"Atributos:
• Nivel Principal:
Permite clasificar los datos en función del idioma principal contemplado en el acuerdo bilateral.",paragraph,127,21,2661,2788
info_cubo_acuerdos_bilaterales_v11.md,>Nota: se indica “no informado” cuando no hay un idioma registrado en el acuerdo.,paragraph,81,19,2790,2871
info_cubo_acuerdos_bilaterales_v11.md,"• Nivel Secundario:
Permite clasificar los datos en función del idioma secundario contemplado en el acuerdo bilateral.",paragraph,118,19,2873,2991
info_cubo_acuerdos_bilaterales_v11.md,>Nota: se indica “no informado” cuando no hay un idioma registrado en el acuerdo.,paragraph,81,19,2993,3074
info_cubo_acuerdos_bilaterales_v11.md,## DIMENSION: Meses ofertados por plaza ##,paragraph,42,10,3076,3118
info_cubo_acuerdos_bilaterales_v11.md,"Notas generales:
- Permite clasificar los datos en función de la duración de la estancia en meses contemplada en el acuerdo.",paragraph,124,23,3120,3244
info_cubo_acuerdos_bilaterales_v11.md,">Nota: las estancias correspondientes a las plazas asignadas a docentes no tienen informada duración (se
indica “No informado”).",paragraph,128,25,3246,3374
info_cubo_acuerdos_bilaterales_v11.md,## DIMENSION: Nivel de estudios ##,paragraph,34,9,3376,3410
info_cubo_acuerdos_bilaterales_v11.md,"Notas generales:
- Permite identificar el nivel formativo de los estudiantes establecido en el acuerdo bilateral.",paragraph,113,18,3412,3525
info_cubo_acuerdos_bilaterales_v11.md,">Valores posibles: Undergraduate, Undergraduate/Postgraduate, Undergraduate/Doctoral,
Undergraduate/Postgraduate/Doctoral, Postgraduate, Postgraduate/Doctoral, Doctoral.",paragraph,169,18,3527,3696
info_cubo_acuerdos_bilaterales_v11.md,>Nota: Para los datos correspondientes a las plazas asignadas a docentes se muestra el valor “(Docentes)”.,paragraph,106,23,3698,3804
info_cubo_acuerdos_bilaterales_v11.md,## DIMENSION: País de la Universidad del Acuerdo ##,paragraph,51,12,3806,3857
info_cubo_acuerdos_bilaterales_v11.md,"Notas generales:
- Permite clasificar los datos en función del país al que pertenece la universidad con la que se firma el acuerd bilateral.",paragraph,140,26,3859,3999
info_cubo_acuerdos_bilaterales_v11.md,## DIMENSION: Programa de Movilidad ##,paragraph,38,9,4001,4039
info_cubo_acuerdos_bilaterales_v11.md,"Notas generales:
- Permite clasificar los datos en función del programa de movilidad en virtud del cual se establece el acuerdo bilateral.",paragraph,138,24,4041,4179
info_cubo_acuerdos_bilaterales_v11.md,## DIMENSION: Universidad del Acuerdo ##,paragraph,40,9,4181,4221
info_cubo_acuerdos_bilaterales_v11.md,"Notas generales:
- Permite clasificar los datos en función de la universidad con la que se firma el acuerdo bilateral.",paragraph,118,22,4223,4341
info_cubo_acuerdos_bilaterales_v11.md,## DIMENSION: Universidad del Acuerdo UNITA (S/N) ##,paragraph,52,13,4343,4395
info_cubo_acuerdos_bilaterales_v11.md,"Notas generales:
- Permite clasificar los datos en función de si la universidad con la que se firma el acuerdo bilateral pertenece alianza de universidades europeas UNITA (S) o no (N).",paragraph,184,37,4397,4581
info_cubo_acuerdos_bilaterales_v11.md,>El primer curso académico en que están registradas universidades UNITA es 2020/21.,paragraph,83,14,4583,4666
info_cubo_acuerdos_bilaterales_v11.md,"=== MEDIDAS ===

** Plazas ofertadas para alumnos **
Número total de plazas de movilidad de entrada y/o de salida que se ofertan, en virtud de programas de intercambio, para realizar una estancia temporal en una universidad (distinta de aquélla en la que se cursan estudios), en el marco de acuerdos bilaterales suscritos por Unizar y registrados en SIGMA.",sentence,356,67,0,356
info_cubo_acuerdos_bilaterales_v11.md,>Nota: El intercambio debe ir asociado a algún tipo de reconocimiento académico.,sentence,80,15,356,436
info_cubo_acuerdos_bilaterales_v11.md,"** Plazas asignadas a los alumnos OUT **
Número total de plazas de movilidad que han sido asignadas a estudiantes de Unizar para realizar estancias otras Universidades, correspondientes a los acuerdos bilaterales registrados en SIGMA.",sentence,234,39,438,672
info_cubo_acuerdos_bilaterales_v11.md,">Nota: sólo se contabilizan plazas de programas de intercambio que tienen informados en SIGMA todos los
datos correspondientes a la solicitud del alumno, a la asignación de plaza y al contrato de estudios.",sentence,205,37,674,879
info_cubo_acuerdos_bilaterales_v11.md,"Por tant se muestran datos correspondientes a los programas ERASMUS y SICUE desde el curso 2012/13, de Movilid UE-Suiza desde el curso 2014/15, y de UZ/NOA y Movilidad Iberoamérica desde el curso 2016/17.",sentence,204,36,881,1085
info_cubo_acuerdos_bilaterales_v11.md,"** Plazas ofertadas a docentes **
Número total de plazas de movilidad que se ofertan al personal docente de entrada y/o salida, en virtud de programas de intercambio suscritos por Unizar, para realizar una estancia temporal en una universidad (distinta de aquélla en que imparten docencia).",sentence,290,53,1086,1376
info_cubo_acuerdos_bilaterales_v11.md,"** Número de acuerdos bilaterales **
Número total de acuerdos de movilidad con otras universidades, registrados en SIGMA, en el marco de los programas de intercambio suscritos por Unizar.",sentence,187,34,1378,1565
info_cubo_acuerdos_bilaterales_v11.md,"=== DIMENSIONES ===

## DIMENSION: CURSO ACADÉMICO ##

Notas generales:
- Clasifica los datos en función del curso académico para el que tiene vigencia el acuerdo bilateral.",sentence,173,32,1567,1740
info_cubo_acuerdos_bilaterales_v11.md,>Nota: El primer curso académico del que constan datos es el 2012/13.,sentence,69,15,1742,1811
info_cubo_acuerdos_bilaterales_v11.md,"## DIMENSION: Centro Responsable ##

Notas generales:
- Permite clasificar los datos en función del centro de Unizar responsable del acuerdo de movilidad.",sentence,154,28,1813,1967
info_cubo_acuerdos_bilaterales_v11.md,">Nota: Para los acuerdos que no tienen centro responsable, se indica 021-Ámbito General.",sentence,88,17,1969,2057
info_cubo_acuerdos_bilaterales_v11.md,"## DIMENSION: Colectivo ##

Notas generales:
- Permite clasificar los datos en función del colectivo al que está destinada la movilidad en el acuerdo bilatera

>Valores posibles: Alumnos, Docentes.",sentence,197,37,2059,2256
info_cubo_acuerdos_bilaterales_v11.md,"## DIMENSION: Entrada o Salida (IN/OUT) ##

Notas generales:
- Permite clasificar los datos en función de si el acuerdo bilateral oferta plazas de movilidad de entrada (IN) o salida (OUT).",sentence,188,42,2258,2446
info_cubo_acuerdos_bilaterales_v11.md,"## DIMENSION: Fecha de actualización ##

Notas generales:
- Indica la fecha de la última recarga de datos.",sentence,106,23,2448,2554
info_cubo_acuerdos_bilaterales_v11.md,Habitualmente se realiza el domingo anterior a la fecha de consulta de datos.,sentence,77,14,2556,2633
info_cubo_acuerdos_bilaterales_v11.md,"## DIMENSION: Idioma ##

Atributos:
• Nivel Principal:
Permite clasificar los datos en función del idioma principal contemplado en el acuerdo bilateral.",sentence,152,28,2634,2786
info_cubo_acuerdos_bilaterales_v11.md,>Nota: se indica “no informado” cuando no hay un idioma registrado en el acuerdo.,sentence,81,19,2788,2869
info_cubo_acuerdos_bilaterales_v11.md,"• Nivel Secundario:
Permite clasificar los datos en función del idioma secundario contemplado en el acuerdo bilateral.",sentence,118,19,2871,2989
info_cubo_acuerdos_bilaterales_v11.md,>Nota: se indica “no informado” cuando no hay un idioma registrado en el acuerdo.,sentence,81,19,2991,3072
info_cubo_acuerdos_bilaterales_v11.md,"## DIMENSION: Meses ofertados por plaza ##

Notas generales:
- Permite clasificar los datos en función de la duración de la estancia en meses contemplada en el acuerdo.",sentence,168,33,3074,3242
info_cubo_acuerdos_bilaterales_v11.md,">Nota: las estancias correspondientes a las plazas asignadas a docentes no tienen informada duración (se
indica “No informado”).",sentence,128,25,3244,3372
info_cubo_acuerdos_bilaterales_v11.md,"## DIMENSION: Nivel de estudios ##

Notas generales:
- Permite identificar el nivel formativo de los estudiantes establecido en el acuerdo bilateral.",sentence,149,27,3374,3523
info_cubo_acuerdos_bilaterales_v11.md,">Valores posibles: Undergraduate, Undergraduate/Postgraduate, Undergraduate/Doctoral,
Undergraduate/Postgraduate/Doctoral, Postgraduate, Postgraduate/Doctoral, Doctoral.",sentence,169,18,3525,3694
info_cubo_acuerdos_bilaterales_v11.md,>Nota: Para los datos correspondientes a las plazas asignadas a docentes se muestra el valor “(Docentes)”.,sentence,106,23,3696,3802
info_cubo_acuerdos_bilaterales_v11.md,"## DIMENSION: País de la Universidad del Acuerdo ##

Notas generales:
- Permite clasificar los datos en función del país al que pertenece la universidad con la que se firma el acuerd bilateral.",sentence,193,38,3804,3997
info_cubo_acuerdos_bilaterales_v11.md,"## DIMENSION: Programa de Movilidad ##

Notas generales:
- Permite clasificar los datos en función del programa de movilidad en virtud del cual se establece el acuerdo bilateral.",sentence,178,33,3999,4177
info_cubo_acuerdos_bilaterales_v11.md,"## DIMENSION: Universidad del Acuerdo ##

Notas generales:
- Permite clasificar los datos en función de la universidad con la que se firma el acuerdo bilateral.",sentence,160,31,4179,4339
info_cubo_acuerdos_bilaterales_v11.md,"## DIMENSION: Universidad del Acuerdo UNITA (S/N) ##

Notas generales:
- Permite clasificar los datos en función de si la universidad con la que se firma el acuerdo bilateral pertenece alianza de universidades europeas UNITA (S) o no (N).",sentence,238,50,4341,4579
info_cubo_acuerdos_bilaterales_v11.md,>El primer curso académico en que están registradas universidades UNITA es 2020/21.,sentence,83,14,4581,4664
info_cubo_admision_v19.md,"=== MEDIDAS ===

** Solicitudes **
Número de peticiones de acceso a un plan de estudios presentadas por los estudiantes que cumplen alguno de los requisitos de acceso a la Universidad que marca la legislación vigente. Notas:

>Si se ejecuta una consulta sin incluir la convocatoria, se contará dos veces a las personas que presenten
una solicitud de admisión en la convocatoria ordinaria y otra en la convocatoria extraordinaria.

>Si se ejecuta una consulta sin incluir el plan de estudios, se contará el número de personas que presentan
una solicitud de admisión.

>Si se ejecuta una consulta incluyendo el plan de estudios, se contarán tantas solicitudes como opciones
de preferencia incluyan los estudiantes en su solicitud de admisión.

** Nota Media **
Nota media de admisión de los estudiantes que participan en el proceso de admisión. Notas:

>Si en la consulta se introduce el plan de estudios, el indicador resultante será la nota media de admisión
de los estudiantes que solicitan admisión en el plan. Si se quiere conocer la nota media de los admitidos, deberá seleccionarse el valor S en la dimensión ""Admitido"" y si se desea conocer la nota media de los matriculados de nuevo ingreso, deberá seleccionarse el valor S en la dimensión ""Matric. Nuevo Ingreso"".

>Es recomendable introducir la dimensión ""cupo adjudicación"" para poder distinguir las notas medias de
admisión del cupo general y de los cupos de reserva.

** Solicitantes **
Número de personas que presentan una solicitud de admisión. Nota:

>Si se ejecuta una consulta sin incluir la convocatoria, se contará a cada estudiante una sola vez,
independientemente de si presenta una o dos solicitudes de admisión en un mismo curso académico.",section,1713,318,0,1713
info_cubo_admision_v19.md,=== DIMENSIONES ===,section,20,3,1714,1734
info_cubo_admision_v19.md,"## DIMENSION: Adjudicación ##

Atributos:
• Admitido (S/N):
Identifica si la solicitud han sido admitida (S) o no (N) en un estudio y curso académico determinados. Notas:

>Un estudiante admitido es aquél al que se le adjudica una plaza de nuevo ingreso, independientemente
de si después formaliza o no la matrícula.

>Esta variable incluye los admitidos en el momento de la adjudicación y los admitidos posteriores, en virtud
de los llamamientos o de un recurso resuelto a su favor.

• Convocatoria:
Clasifica las solicitudes en función de si participan en la convocatoria ordinaria de admisión o en la extraordinaria.

• Estado:
Distingue si las solicitudes han sido admitidas (en el proceso de adjudicación), admitidas posteriores (en virtud de un llamamiento o de un recurso resuelto a favor del solicitante), se encuentran en lista de espera, no han sido consideradas por tratarse de una preferencia posterior a la de un plan de estudios en que ha sido admitido el solicitante, o han sido desactivadas por llamamiento (si ha sido llamado en cualquier estudio y en cualquier cupo, se desactiva el estudio que tenga por debajo de sus preferencias).

• Matriculado de Nuevo Ingreso (S/N):
Indica si el solicitante ha formalizado su matrícula (S) o no (N) en el estudio y curso académico en que ha sido admitido. Notas:

>Se identifica con la persona que se matricula en un plan de estudios, consumiendo alguna de las plazas
ofertadas para ese año y plan.

>No se consideran matriculados de nuevo ingreso los que acceden a un estudio por el procedimiento de
cambio de estudios, traslado de expediente o de adaptación al grado.

• Tipo de Acceso:
Distingue entre solicitudes participantes en el proceso de preinscripción (adjudicación por distrito propio) y matrícula directa sin necesidad de realizar solicitud de admisión en aquellos planes de estudios con plazas vacantes que activen este procedimiento en la convocatoria extraordinaria (adjudicación extraordinaria).

• Tipo de Procedimiento:
Clasifica las solicitudes en función de si han sido o no objeto de reclamación tras el proceso de adjudicación. Valores posibles:

>Normal: el solicitante no presenta reclamación a las listas de admisión y, por tanto, no hay cambios tras
el resultado de adjudicación.

>Recurso: el solicitante presenta reclamación a las listas de admisión, resolviéndose ésta a favor del
solicitante y modificándose su posición en las listas de admisión.",section,2436,453,1735,4171
info_cubo_admision_v19.md,"## DIMENSION: CURSO ACADÉMICO ##

Notas generales:
- Identifica los diferentes cursos académicos (por ejemplo 2021/22).",section,120,23,4172,4292
info_cubo_admision_v19.md,"## DIMENSION: Fecha de actualización ##

Notas generales:
- Indica la fecha de la última recarga de datos. Habitualmente es el domingo anterior a la consulta de datos.",section,168,34,4293,4461
info_cubo_admision_v19.md,"## DIMENSION: Solicitante ##

Atributos:
• País de Nacionalidad:
Permite clasificar los datos en función del país de nacionalidad legal de los solicitantes.

• Población de nacimiento:
Identifica el país, la comunidad autónoma, la provincia o la población de nacimiento informada por el solicitante.

• Rango de Edad:
Permite agrupar los rangos de edad de los solicitantes en función de su edad a 31 de diciembre del curso académico en que solicitan admisión.

>Valores posibles: 18 años o menos, 19, 20, 21, 22, 23, 24, 25, 26, 27, 28, 29, 30 a 34, 35 a 39, 40 a 44, 45
a 49, 50 a 54, 55 a 59, 60 a 64, 65 años o más.

• Residencia Familiar:
Identifica el país, la comunidad autónoma, la provincia o la población de residencia familiar informada por el solicitante.

• Sexo:
Permite agrupar los solicitantes en función de su sexo.

• Universidad de Origen:
Clasifica a los solicitantes en función de la universidad de la que proceden (en la que han cursado estudios previos o en la que han superado las Pruebas de Acceso correspondientes).",section,1041,226,4462,5503
info_cubo_admision_v19.md,"## DIMENSION: Solicitud ##

Atributos:
• Centro:
Permite clasificar las solicitudes en función del centro en que se imparte la titulación solicitada.

• Centro Campus:
Permite clasificar las solicitudes en función del campus en que se ubica el centro en que se imparte la titulación solicitada.

• Centro Localidad:
Permite clasificar las solicitudes en función de la localidad en que se ubica el centro en que se imparte la titulación solicitada.

• Centro Tipo:
Permite clasificar las solicitudes en función del tipo de centro (facultad, escuela universitaria, centro adscrito, etc.) en que se imparte la titulación solicitada.

• Cupo de Adjudicación:
Clasifica las solicitudes en función de si participan del cupo general (EVAU-PAU, CFGS, Credencial UNED) o de los de reserva (titulados universitarios o equivalentes, mayores de 25 años, mayores de 45 años, mayores de 40 años con experiencia profesional, discapacitados, deportistas de alto nivel o de alto rendimiento).

• Estudio Previo:
Identifica la clase de estudio cursado anteriormente por los estudiantes, que les da acceso a la Universidad, de acuerdo con los requisitos establecidos por la legislación vigente.

>Valores posibles: Pruebas de Acceso, COU sin PAU, FP, Titulados Universitarios, Mayores de 25, Mayores
de 40, Mayores de 45.

>Los estudiantes procedentes de Bachillerato se incluyen en “Pruebas de Acceso”. Los estudiantes
procedentes de Ciclos Formativos de Grado Superior se incluyen en “FP”, aunque se hayan presentado a la fase específica de la EvAU.

>Nota: el valor “No informado” se aplica a estudiantes procedentes de adaptaciones por extinción de
planes de estudios o que no han accedido a la titulación por procedimientos de preinscripción.

• Orden de Preferencia:
Clasifica las solicitudes en función del orden de preferencia consignada en la solicitud de admisión para cada una de las titulaciones solicitadas.

>Valores posibles: 1, 2, 3, 4, 5, 6, 7, 8, 9, 10.

• Rango de calificación:
Clasifica las solicitudes en función del rango de la nota de admisión válida para cada una de las titulaciones solicitadas.

>Valores posibles: entre 5 y 6, entre 6 y 7, entre 7 y 8, entre 8 y 9, entre 9 y 10, entre 10 y 11, entre 11 y
12, entre 12 y 13, entre 13 y 14.

• Titulación Estudio:
Permite identificar el estudio solicitado en el proceso de admisión.

• Titulación Plan:
Permite identificar el plan de estudios solicitado en el proceso de admisión.

• Titulación Rama:
Permite identificar la rama de conocimiento asignada a la titulación solicitada en el proceso de admisión.

• Titulación Tipo:
Permite identificar el tipo de titulación solicitada: grado, licenciatura o equivalente, diplomatura o equivalente.",section,2703,523,5504,8207
info_cubo_admision_v19.md,=== MEDIDAS ===,paragraph,15,3,0,15
info_cubo_admision_v19.md,"** Solicitudes **
Número de peticiones de acceso a un plan de estudios presentadas por los estudiantes que cumplen alguno de los requisitos de acceso a la Universidad que marca la legislación vigente. Notas:",paragraph,207,38,17,224
info_cubo_admision_v19.md,">Si se ejecuta una consulta sin incluir la convocatoria, se contará dos veces a las personas que presenten
una solicitud de admisión en la convocatoria ordinaria y otra en la convocatoria extraordinaria.",paragraph,203,35,226,429
info_cubo_admision_v19.md,">Si se ejecuta una consulta sin incluir el plan de estudios, se contará el número de personas que presentan
una solicitud de admisión.",paragraph,134,26,431,565
info_cubo_admision_v19.md,">Si se ejecuta una consulta incluyendo el plan de estudios, se contarán tantas solicitudes como opciones
de preferencia incluyan los estudiantes en su solicitud de admisión.",paragraph,173,29,567,740
info_cubo_admision_v19.md,"** Nota Media **
Nota media de admisión de los estudiantes que participan en el proceso de admisión. Notas:",paragraph,107,23,742,849
info_cubo_admision_v19.md,">Si en la consulta se introduce el plan de estudios, el indicador resultante será la nota media de admisión
de los estudiantes que solicitan admisión en el plan. Si se quiere conocer la nota media de los admitidos, deberá seleccionarse el valor S en la dimensión ""Admitido"" y si se desea conocer la nota media de los matriculados de nuevo ingreso, deberá seleccionarse el valor S en la dimensión ""Matric. Nuevo Ingreso"".",paragraph,420,83,851,1271
info_cubo_admision_v19.md,">Es recomendable introducir la dimensión ""cupo adjudicación"" para poder distinguir las notas medias de
admisión del cupo general y de los cupos de reserva.",paragraph,155,28,1273,1428
info_cubo_admision_v19.md,"** Solicitantes **
Número de personas que presentan una solicitud de admisión. Nota:",paragraph,84,17,1430,1514
info_cubo_admision_v19.md,">Si se ejecuta una consulta sin incluir la convocatoria, se contará a cada estudiante una sola vez,
independientemente de si presenta una o dos solicitudes de admisión en un mismo curso académico.",paragraph,196,36,1516,1712
info_cubo_admision_v19.md,=== DIMENSIONES ===,paragraph,19,3,1714,1733
info_cubo_admision_v19.md,## DIMENSION: Adjudicación ##,paragraph,29,7,1735,1764
info_cubo_admision_v19.md,"Atributos:
• Admitido (S/N):
Identifica si la solicitud han sido admitida (S) o no (N) en un estudio y curso académico determinados. Notas:",paragraph,139,33,1766,1905
info_cubo_admision_v19.md,">Un estudiante admitido es aquél al que se le adjudica una plaza de nuevo ingreso, independientemente
de si después formaliza o no la matrícula.",paragraph,144,27,1907,2051
info_cubo_admision_v19.md,">Esta variable incluye los admitidos en el momento de la adjudicación y los admitidos posteriores, en virtud
de los llamamientos o de un recurso resuelto a su favor.",paragraph,165,31,2053,2218
info_cubo_admision_v19.md,"• Convocatoria:
Clasifica las solicitudes en función de si participan en la convocatoria ordinaria de admisión o en la extraordinaria.",paragraph,134,22,2220,2354
info_cubo_admision_v19.md,"• Estado:
Distingue si las solicitudes han sido admitidas (en el proceso de adjudicación), admitidas posteriores (en virtud de un llamamiento o de un recurso resuelto a favor del solicitante), se encuentran en lista de espera, no han sido consideradas por tratarse de una preferencia posterior a la de un plan de estudios en que ha sido admitido el solicitante, o han sido desactivadas por llamamiento (si ha sido llamado en cualquier estudio y en cualquier cupo, se desactiva el estudio que tenga por debajo de sus preferencias).",paragraph,530,101,2356,2886
info_cubo_admision_v19.md,"• Matriculado de Nuevo Ingreso (S/N):
Indica si el solicitante ha formalizado su matrícula (S) o no (N) en el estudio y curso académico en que ha sido admitido. Notas:",paragraph,167,39,2888,3055
info_cubo_admision_v19.md,">Se identifica con la persona que se matricula en un plan de estudios, consumiendo alguna de las plazas
ofertadas para ese año y plan.",paragraph,134,27,3057,3191
info_cubo_admision_v19.md,">No se consideran matriculados de nuevo ingreso los que acceden a un estudio por el procedimiento de
cambio de estudios, traslado de expediente o de adaptación al grado.",paragraph,169,31,3193,3362
info_cubo_admision_v19.md,"• Tipo de Acceso:
Distingue entre solicitudes participantes en el proceso de preinscripción (adjudicación por distrito propio) y matrícula directa sin necesidad de realizar solicitud de admisión en aquellos planes de estudios con plazas vacantes que activen este procedimiento en la convocatoria extraordinaria (adjudicación extraordinaria).",paragraph,341,51,3364,3705
info_cubo_admision_v19.md,"• Tipo de Procedimiento:
Clasifica las solicitudes en función de si han sido o no objeto de reclamación tras el proceso de adjudicación. Valores posibles:",paragraph,154,28,3707,3861
info_cubo_admision_v19.md,">Normal: el solicitante no presenta reclamación a las listas de admisión y, por tanto, no hay cambios tras
el resultado de adjudicación.",paragraph,136,27,3863,3999
info_cubo_admision_v19.md,">Recurso: el solicitante presenta reclamación a las listas de admisión, resolviéndose ésta a favor del
solicitante y modificándose su posición en las listas de admisión.",paragraph,169,29,4001,4170
info_cubo_admision_v19.md,## DIMENSION: CURSO ACADÉMICO ##,paragraph,32,8,4172,4204
info_cubo_admision_v19.md,"Notas generales:
- Identifica los diferentes cursos académicos (por ejemplo 2021/22).",paragraph,85,15,4206,4291
info_cubo_admision_v19.md,## DIMENSION: Fecha de actualización ##,paragraph,39,9,4293,4332
info_cubo_admision_v19.md,"Notas generales:
- Indica la fecha de la última recarga de datos. Habitualmente es el domingo anterior a la consulta de datos.",paragraph,126,25,4334,4460
info_cubo_admision_v19.md,## DIMENSION: Solicitante ##,paragraph,28,7,4462,4490
info_cubo_admision_v19.md,"Atributos:
• País de Nacionalidad:
Permite clasificar los datos en función del país de nacionalidad legal de los solicitantes.",paragraph,126,22,4492,4618
info_cubo_admision_v19.md,"• Población de nacimiento:
Identifica el país, la comunidad autónoma, la provincia o la población de nacimiento informada por el solicitante.",paragraph,141,25,4620,4761
info_cubo_admision_v19.md,"• Rango de Edad:
Permite agrupar los rangos de edad de los solicitantes en función de su edad a 31 de diciembre del curso académico en que solicitan admisión.",paragraph,158,31,4763,4921
info_cubo_admision_v19.md,">Valores posibles: 18 años o menos, 19, 20, 21, 22, 23, 24, 25, 26, 27, 28, 29, 30 a 34, 35 a 39, 40 a 44, 45
a 49, 50 a 54, 55 a 59, 60 a 64, 65 años o más.",paragraph,157,64,4923,5080
info_cubo_admision_v19.md,"• Residencia Familiar:
Identifica el país, la comunidad autónoma, la provincia o la población de residencia familiar informada por el solicitante.",paragraph,146,25,5082,5228
info_cubo_admision_v19.md,"• Sexo:
Permite agrupar los solicitantes en función de su sexo.",paragraph,63,13,5230,5293
info_cubo_admision_v19.md,"• Universidad de Origen:
Clasifica a los solicitantes en función de la universidad de la que proceden (en la que han cursado estudios previos o en la que han superado las Pruebas de Acceso correspondientes).",paragraph,207,39,5295,5502
info_cubo_admision_v19.md,## DIMENSION: Solicitud ##,paragraph,26,7,5504,5530
info_cubo_admision_v19.md,"Atributos:
• Centro:
Permite clasificar las solicitudes en función del centro en que se imparte la titulación solicitada.",paragraph,121,21,5532,5653
info_cubo_admision_v19.md,"• Centro Campus:
Permite clasificar las solicitudes en función del campus en que se ubica el centro en que se imparte la titulación solicitada.",paragraph,143,26,5655,5798
info_cubo_admision_v19.md,"• Centro Localidad:
Permite clasificar las solicitudes en función de la localidad en que se ubica el centro en que se imparte la titulación solicitada.",paragraph,151,27,5800,5951
info_cubo_admision_v19.md,"• Centro Tipo:
Permite clasificar las solicitudes en función del tipo de centro (facultad, escuela universitaria, centro adscrito, etc.) en que se imparte la titulación solicitada.",paragraph,180,34,5953,6133
info_cubo_admision_v19.md,"• Cupo de Adjudicación:
Clasifica las solicitudes en función de si participan del cupo general (EVAU-PAU, CFGS, Credencial UNED) o de los de reserva (titulados universitarios o equivalentes, mayores de 25 años, mayores de 45 años, mayores de 40 años con experiencia profesional, discapacitados, deportistas de alto nivel o de alto rendimiento).",paragraph,344,65,6135,6479
info_cubo_admision_v19.md,"• Estudio Previo:
Identifica la clase de estudio cursado anteriormente por los estudiantes, que les da acceso a la Universidad, de acuerdo con los requisitos establecidos por la legislación vigente.",paragraph,198,34,6481,6679
info_cubo_admision_v19.md,">Valores posibles: Pruebas de Acceso, COU sin PAU, FP, Titulados Universitarios, Mayores de 25, Mayores
de 40, Mayores de 45.",paragraph,125,29,6681,6806
info_cubo_admision_v19.md,">Los estudiantes procedentes de Bachillerato se incluyen en “Pruebas de Acceso”. Los estudiantes
procedentes de Ciclos Formativos de Grado Superior se incluyen en “FP”, aunque se hayan presentado a la fase específica de la EvAU.",paragraph,228,43,6808,7036
info_cubo_admision_v19.md,">Nota: el valor “No informado” se aplica a estudiantes procedentes de adaptaciones por extinción de
planes de estudios o que no han accedido a la titulación por procedimientos de preinscripción.",paragraph,194,35,7038,7232
info_cubo_admision_v19.md,"• Orden de Preferencia:
Clasifica las solicitudes en función del orden de preferencia consignada en la solicitud de admisión para cada una de las titulaciones solicitadas.",paragraph,171,28,7234,7405
info_cubo_admision_v19.md,">Valores posibles: 1, 2, 3, 4, 5, 6, 7, 8, 9, 10.",paragraph,49,24,7407,7456
info_cubo_admision_v19.md,"• Rango de calificación:
Clasifica las solicitudes en función del rango de la nota de admisión válida para cada una de las titulaciones solicitadas.",paragraph,148,26,7458,7606
info_cubo_admision_v19.md,">Valores posibles: entre 5 y 6, entre 6 y 7, entre 7 y 8, entre 8 y 9, entre 9 y 10, entre 10 y 11, entre 11 y
12, entre 12 y 13, entre 13 y 14.",paragraph,144,49,7608,7752
info_cubo_admision_v19.md,"• Titulación Estudio:
Permite identificar el estudio solicitado en el proceso de admisión.",paragraph,90,15,7754,7844
info_cubo_admision_v19.md,"• Titulación Plan:
Permite identificar el plan de estudios solicitado en el proceso de admisión.",paragraph,96,17,7846,7942
info_cubo_admision_v19.md,"• Titulación Rama:
Permite identificar la rama de conocimiento asignada a la titulación solicitada en el proceso de admisión.",paragraph,125,21,7944,8069
info_cubo_admision_v19.md,"• Titulación Tipo:
Permite identificar el tipo de titulación solicitada: grado, licenciatura o equivalente, diplomatura o equivalente.",paragraph,134,22,8071,8205
info_cubo_admision_v19.md,"=== MEDIDAS ===

** Solicitudes **
Número de peticiones de acceso a un plan de estudios presentadas por los estudiantes que cumplen alguno de los requisitos de acceso a la Universidad que marca la legislación vigente.",sentence,217,39,0,217
info_cubo_admision_v19.md,"Notas:

>Si se ejecuta una consulta sin incluir la convocatoria, se contará dos veces a las personas que presenten
una solicitud de admisión en la convocatoria ordinaria y otra en la convocatoria extraordinaria.",sentence,211,37,217,428
info_cubo_admision_v19.md,">Si se ejecuta una consulta sin incluir el plan de estudios, se contará el número de personas que presentan
una solicitud de admisión.",sentence,134,26,429,563
info_cubo_admision_v19.md,">Si se ejecuta una consulta incluyendo el plan de estudios, se contarán tantas solicitudes como opciones
de preferencia incluyan los estudiantes en su solicitud de admisión.",sentence,173,29,565,738
info_cubo_admision_v19.md,"** Nota Media **
Nota media de admisión de los estudiantes que participan en el proceso de admisión.",sentence,100,21,740,840
info_cubo_admision_v19.md,"Notas:

>Si en la consulta se introduce el plan de estudios, el indicador resultante será la nota media de admisión
de los estudiantes que solicitan admisión en el plan.",sentence,169,33,842,1011
info_cubo_admision_v19.md,"Si se quiere conocer la nota media de los admitidos, deberá seleccionarse el valor S en la dimensión ""Admitido"" y si se desea conocer la nota media de los matriculados de nuevo ingreso, deberá seleccionarse el valor S en la dimensión ""Matric.",sentence,242,48,1012,1254
info_cubo_admision_v19.md,"Nuevo Ingreso"".",sentence,15,4,1255,1270
info_cubo_admision_v19.md,">Es recomendable introducir la dimensión ""cupo adjudicación"" para poder distinguir las notas medias de
admisión del cupo general y de los cupos de reserva.",sentence,155,28,1271,1426
info_cubo_admision_v19.md,"** Solicitantes **
Número de personas que presentan una solicitud de admisión.",sentence,78,15,1428,1506
info_cubo_admision_v19.md,"Nota:

>Si se ejecuta una consulta sin incluir la convocatoria, se contará a cada estudiante una sola vez,
independientemente de si presenta una o dos solicitudes de admisión en un mismo curso académico.",sentence,203,38,1508,1711
info_cubo_admision_v19.md,"=== DIMENSIONES ===

## DIMENSION: Adjudicación ##

Atributos:
• Admitido (S/N):
Identifica si la solicitud han sido admitida (S) o no (N) en un estudio y curso académico determinados.",sentence,184,41,1712,1896
info_cubo_admision_v19.md,"Notas:

>Un estudiante admitido es aquél al que se le adjudica una plaza de nuevo ingreso, independientemente
de si después formaliza o no la matrícula.",sentence,152,29,1898,2050
info_cubo_admision_v19.md,">Esta variable incluye los admitidos en el momento de la adjudicación y los admitidos posteriores, en virtud
de los llamamientos o de un recurso resuelto a su favor.",sentence,165,31,2051,2216
info_cubo_admision_v19.md,"• Convocatoria:
Clasifica las solicitudes en función de si participan en la convocatoria ordinaria de admisión o en la extraordinaria.",sentence,134,22,2218,2352
info_cubo_admision_v19.md,"• Estado:
Distingue si las solicitudes han sido admitidas (en el proceso de adjudicación), admitidas posteriores (en virtud de un llamamiento o de un recurso resuelto a favor del solicitante), se encuentran en lista de espera, no han sido consideradas por tratarse de una preferencia posterior a la de un plan de estudios en que ha sido admitido el solicitante, o han sido desactivadas por llamamiento (si ha sido llamado en cualquier estudio y en cualquier cupo, se desactiva el estudio que tenga por debajo de sus preferencias).",sentence,530,101,2354,2884
info_cubo_admision_v19.md,"• Matriculado de Nuevo Ingreso (S/N):
Indica si el solicitante ha formalizado su matrícula (S) o no (N) en el estudio y curso académico en que ha sido admitido.",sentence,160,37,2886,3046
info_cubo_admision_v19.md,"Notas:

>Se identifica con la persona que se matricula en un plan de estudios, consumiendo alguna de las plazas
ofertadas para ese año y plan.",sentence,142,29,3048,3190
info_cubo_admision_v19.md,">No se consideran matriculados de nuevo ingreso los que acceden a un estudio por el procedimiento de
cambio de estudios, traslado de expediente o de adaptación al grado.",sentence,169,31,3191,3360
info_cubo_admision_v19.md,"• Tipo de Acceso:
Distingue entre solicitudes participantes en el proceso de preinscripción (adjudicación por distrito propio) y matrícula directa sin necesidad de realizar solicitud de admisión en aquellos planes de estudios con plazas vacantes que activen este procedimiento en la convocatoria extraordinaria (adjudicación extraordinaria).",sentence,341,51,3362,3703
info_cubo_admision_v19.md,"• Tipo de Procedimiento:
Clasifica las solicitudes en función de si han sido o no objeto de reclamación tras el proceso de adjudicación.",sentence,136,25,3705,3841
info_cubo_admision_v19.md,"Valores posibles:

>Normal: el solicitante no presenta reclamación a las listas de admisión y, por tanto, no hay cambios tras
el resultado de adjudicación.",sentence,155,30,3843,3998
info_cubo_admision_v19.md,">Recurso: el solicitante presenta reclamación a las listas de admisión, resolviéndose ésta a favor del
solicitante y modificándose su posición en las listas de admisión.",sentence,169,29,3999,4168
info_cubo_admision_v19.md,"## DIMENSION: CURSO ACADÉMICO ##

Notas generales:
- Identifica los diferentes cursos académicos (por ejemplo 2021/22).",sentence,119,23,4170,4289
info_cubo_admision_v19.md,"## DIMENSION: Fecha de actualización ##

Notas generales:
- Indica la fecha de la última recarga de datos.",sentence,106,23,4291,4397
info_cubo_admision_v19.md,Habitualmente es el domingo anterior a la consulta de datos.,sentence,60,11,4399,4459
info_cubo_admision_v19.md,"## DIMENSION: Solicitante ##

Atributos:
• País de Nacionalidad:
Permite clasificar los datos en función del país de nacionalidad legal de los solicitantes.",sentence,156,29,4460,4616
info_cubo_admision_v19.md,"• Población de nacimiento:
Identifica el país, la comunidad autónoma, la provincia o la población de nacimiento informada por el solicitante.",sentence,141,25,4618,4759
info_cubo_admision_v19.md,"• Rango de Edad:
Permite agrupar los rangos de edad de los solicitantes en función de su edad a 31 de diciembre del curso académico en que solicitan admisión.",sentence,158,31,4761,4919
info_cubo_admision_v19.md,">Valores posibles: 18 años o menos, 19, 20, 21, 22, 23, 24, 25, 26, 27, 28, 29, 30 a 34, 35 a 39, 40 a 44, 45
a 49, 50 a 54, 55 a 59, 60 a 64, 65 años o más.",sentence,157,64,4921,5078
info_cubo_admision_v19.md,"• Residencia Familiar:
Identifica el país, la comunidad autónoma, la provincia o la población de residencia familiar informada por el solicitante.",sentence,146,25,5080,5226
info_cubo_admision_v19.md,"• Sexo:
Permite agrupar los solicitantes en función de su sexo.",sentence,63,13,5228,5291
info_cubo_admision_v19.md,"• Universidad de Origen:
Clasifica a los solicitantes en función de la universidad de la que proceden (en la que han cursado estudios previos o en la que han superado las Pruebas de Acceso correspondientes).",sentence,207,39,5293,5500
info_cubo_admision_v19.md,"## DIMENSION: Solicitud ##

Atributos:
• Centro:
Permite clasificar las solicitudes en función del centro en que se imparte la titulación solicitada.",sentence,149,28,5502,5651
info_cubo_admision_v19.md,"• Centro Campus:
Permite clasificar las solicitudes en función del campus en que se ubica el centro en que se imparte la titulación solicitada.",sentence,143,26,5653,5796
info_cubo_admision_v19.md,"• Centro Localidad:
Permite clasificar las solicitudes en función de la localidad en que se ubica el centro en que se imparte la titulación solicitada.",sentence,151,27,5798,5949
info_cubo_admision_v19.md,"• Centro Tipo:
Permite clasificar las solicitudes en función del tipo de centro (facultad, escuela universitaria, centro adscrito, etc.)",sentence,136,26,5951,6087
info_cubo_admision_v19.md,en que se imparte la titulación solicitada.,sentence,43,8,6089,6132
info_cubo_admision_v19.md,"• Cupo de Adjudicación:
Clasifica las solicitudes en función de si participan del cupo general (EVAU-PAU, CFGS, Credencial UNED) o de los de reserva (titulados universitarios o equivalentes, mayores de 25 años, mayores de 45 años, mayores de 40 años con experiencia profesional, discapacitados, deportistas de alto nivel o de alto rendimiento).",sentence,344,65,6133,6477
info_cubo_admision_v19.md,"• Estudio Previo:
Identifica la clase de estudio cursado anteriormente por los estudiantes, que les da acceso a la Universidad, de acuerdo con los requisitos establecidos por la legislación vigente.",sentence,198,34,6479,6677
info_cubo_admision_v19.md,">Valores posibles: Pruebas de Acceso, COU sin PAU, FP, Titulados Universitarios, Mayores de 25, Mayores
de 40, Mayores de 45.",sentence,125,29,6679,6804
info_cubo_admision_v19.md,>Los estudiantes procedentes de Bachillerato se incluyen en “Pruebas de Acceso”.,sentence,80,15,6806,6886
info_cubo_admision_v19.md,"Los estudiantes
procedentes de Ciclos Formativos de Grado Superior se incluyen en “FP”, aunque se hayan presentado a la fase específica de la EvAU.",sentence,147,28,6888,7035
info_cubo_admision_v19.md,">Nota: el valor “No informado” se aplica a estudiantes procedentes de adaptaciones por extinción de
planes de estudios o que no han accedido a la titulación por procedimientos de preinscripción.",sentence,194,35,7036,7230
info_cubo_admision_v19.md,"• Orden de Preferencia:
Clasifica las solicitudes en función del orden de preferencia consignada en la solicitud de admisión para cada una de las titulaciones solicitadas.",sentence,171,28,7232,7403
info_cubo_admision_v19.md,">Valores posibles: 1, 2, 3, 4, 5, 6, 7, 8, 9, 10.",sentence,49,24,7405,7454
info_cubo_admision_v19.md,"• Rango de calificación:
Clasifica las solicitudes en función del rango de la nota de admisión válida para cada una de las titulaciones solicitadas.",sentence,148,26,7456,7604
info_cubo_admision_v19.md,">Valores posibles: entre 5 y 6, entre 6 y 7, entre 7 y 8, entre 8 y 9, entre 9 y 10, entre 10 y 11, entre 11 y
12, entre 12 y 13, entre 13 y 14.",sentence,144,49,7606,7750
info_cubo_admision_v19.md,"• Titulación Estudio:
Permite identificar el estudio solicitado en el proceso de admisión.",sentence,90,15,7752,7842
info_cubo_admision_v19.md,"• Titulación Plan:
Permite identificar el plan de estudios solicitado en el proceso de admisión.",sentence,96,17,7844,7940
info_cubo_admision_v19.md,"• Titulación Rama:
Permite identificar la rama de conocimiento asignada a la titulación solicitada en el proceso de admisión.",sentence,125,21,7942,8067
info_cubo_admision_v19.md,"• Titulación Tipo:
Permite identificar el tipo de titulación solicitada: grado, licenciatura o equivalente, diplomatura o equivalente.",sentence,134,22,8069,8203
info_cubo_cargo_v14.md,"=== MEDIDAS ===

** Número de cargos **
Número de órganos unipersonales de representación que ostentan cargos, entre otros, del Consejo de Dirección, de los Centros, de los Departamentos y de los Institutos Universitarios de Investigación propios de Universidad de Zaragoza.",section,275,48,0,275
info_cubo_cargo_v14.md,=== DIMENSIONES ===,section,20,3,276,296
info_cubo_cargo_v14.md,"## DIMENSION: Cargo ##

Notas generales:
- Permite identificar los cargos existentes según su denominación.

Atributos:
• Importe Teórico:
Permite clasificar los cargos en función del importe del complemento retributivo que perciben por su desempeño. El importe teórico es complementario de la dimensión “remunerado”.

>Aclaración: “No informado” indica que el cargo no conlleva remuneración o que una misma persona ocupa d
cargos y sólo es posible disfrutar de un complemento retributivo por el desempeño de cargos académicos.

• Reducción:
Permite clasificar los cargos en función de la reducción en horas lectivas anuales o en porcentaje, como consecuencia del desempeño del cargo.

• Tipo:
Permite agrupar los cargos existentes según su tipología. Ejemplos: Vicerrectores, Decanos, Directores de Departamento, Directores de IUI, Coordinadores de Grado, etc.",section,862,152,297,1159
info_cubo_cargo_v14.md,"## DIMENSION: Centro ##

Notas generales:
- Permite clasificar los datos en función del centro al que están adscritos los cargos.",section,130,26,1160,1290
info_cubo_cargo_v14.md,"## DIMENSION: Departamento ##

Notas generales:
- Permite clasificar los datos en función del departamento al que están adscritos los cargos.",section,142,26,1291,1433
info_cubo_cargo_v14.md,"## DIMENSION: Fecha de actualización ##

Notas generales:
- Indica la fecha de la última recarga de datos. Habitualmente es el domingo anterior a la consulta de datos.",section,168,34,1434,1602
info_cubo_cargo_v14.md,"## DIMENSION: PAS/PDI ##

Notas generales:
- Permite agrupar los datos en función de si el cargo lo desempeña un PDI o un PAS.",section,127,29,1603,1730
info_cubo_cargo_v14.md,"## DIMENSION: Rango de Edad ##

Notas generales:
- Permite agrupar los rangos de edad de los cargos en función de su fecha de nacimiento.

>Valores posibles: 20 años o menos, 21 a 30, 31 a 40, 41 a 50, 51 a 60, 60 años o más.",section,226,60,1731,1957
info_cubo_cargo_v14.md,"## DIMENSION: Remunerado ##

Notas generales:
- Permite clasificar los cargos en función de si perciben un complemento retributivo (S) o no (N) por su desempeño.",section,162,35,1958,2120
info_cubo_cargo_v14.md,"## DIMENSION: Sexo ##

Notas generales:
- Permite agrupar los cargos en función de su sexo.",section,92,21,2121,2213
info_cubo_cargo_v14.md,"## DIMENSION: TIEMPO ##

Notas generales:
- Permite ubicar en el tiempo la relación de los cargos con la UZ. Se pueden desglosar los datos según el año o mes: • MES: se incluyen los cargos existentes a fecha último día del mes seleccionado (si se trata de un mes e curso, se incluyen los cargos existentes a la fecha de la última carga). • AÑO: se acumulan los cargos existentes a fecha último día de todos los meses del año seleccionado (si año seleccionado es un año en curso, se acumulan los cargos existentes a fecha último día de los mese anteriores y para el mes en curso los cargos existentes a la fecha de la última carga).",section,632,135,2214,2846
info_cubo_cargo_v14.md,"## DIMENSION: Unidad ##

Notas generales:
- Permite clasificar los datos en función de la unidad a la que están adscritos los cargos.",section,135,28,2847,2982
info_cubo_cargo_v14.md,=== MEDIDAS ===,paragraph,15,3,0,15
info_cubo_cargo_v14.md,"** Número de cargos **
Número de órganos unipersonales de representación que ostentan cargos, entre otros, del Consejo de Dirección, de los Centros, de los Departamentos y de los Institutos Universitarios de Investigación propios de Universidad de Zaragoza.",paragraph,257,45,17,274
info_cubo_cargo_v14.md,=== DIMENSIONES ===,paragraph,19,3,276,295
info_cubo_cargo_v14.md,## DIMENSION: Cargo ##,paragraph,22,7,297,319
info_cubo_cargo_v14.md,"Notas generales:
- Permite identificar los cargos existentes según su denominación.",paragraph,83,13,321,404
info_cubo_cargo_v14.md,"Atributos:
• Importe Teórico:
Permite clasificar los cargos en función del importe del complemento retributivo que perciben por su desempeño. El importe teórico es complementario de la dimensión “remunerado”.",paragraph,208,35,406,614
info_cubo_cargo_v14.md,">Aclaración: “No informado” indica que el cargo no conlleva remuneración o que una misma persona ocupa d
cargos y sólo es posible disfrutar de un complemento retributivo por el desempeño de cargos académicos.",paragraph,208,38,616,824
info_cubo_cargo_v14.md,"• Reducción:
Permite clasificar los cargos en función de la reducción en horas lectivas anuales o en porcentaje, como consecuencia del desempeño del cargo.",paragraph,155,27,826,981
info_cubo_cargo_v14.md,"• Tipo:
Permite agrupar los cargos existentes según su tipología. Ejemplos: Vicerrectores, Decanos, Directores de Departamento, Directores de IUI, Coordinadores de Grado, etc.",paragraph,175,32,983,1158
info_cubo_cargo_v14.md,## DIMENSION: Centro ##,paragraph,23,7,1160,1183
info_cubo_cargo_v14.md,"Notas generales:
- Permite clasificar los datos en función del centro al que están adscritos los cargos.",paragraph,104,19,1185,1289
info_cubo_cargo_v14.md,## DIMENSION: Departamento ##,paragraph,29,7,1291,1320
info_cubo_cargo_v14.md,"Notas generales:
- Permite clasificar los datos en función del departamento al que están adscritos los cargos.",paragraph,110,19,1322,1432
info_cubo_cargo_v14.md,## DIMENSION: Fecha de actualización ##,paragraph,39,9,1434,1473
info_cubo_cargo_v14.md,"Notas generales:
- Indica la fecha de la última recarga de datos. Habitualmente es el domingo anterior a la consulta de datos.",paragraph,126,25,1475,1601
info_cubo_cargo_v14.md,## DIMENSION: PAS/PDI ##,paragraph,24,7,1603,1627
info_cubo_cargo_v14.md,"Notas generales:
- Permite agrupar los datos en función de si el cargo lo desempeña un PDI o un PAS.",paragraph,100,22,1629,1729
info_cubo_cargo_v14.md,## DIMENSION: Rango de Edad ##,paragraph,30,9,1731,1761
info_cubo_cargo_v14.md,"Notas generales:
- Permite agrupar los rangos de edad de los cargos en función de su fecha de nacimiento.",paragraph,105,21,1763,1868
info_cubo_cargo_v14.md,">Valores posibles: 20 años o menos, 21 a 30, 31 a 40, 41 a 50, 51 a 60, 60 años o más.",paragraph,86,30,1870,1956
info_cubo_cargo_v14.md,## DIMENSION: Remunerado ##,paragraph,27,7,1958,1985
info_cubo_cargo_v14.md,"Notas generales:
- Permite clasificar los cargos en función de si perciben un complemento retributivo (S) o no (N) por su desempeño.",paragraph,132,28,1987,2119
info_cubo_cargo_v14.md,## DIMENSION: Sexo ##,paragraph,21,7,2121,2142
info_cubo_cargo_v14.md,"Notas generales:
- Permite agrupar los cargos en función de su sexo.",paragraph,68,14,2144,2212
info_cubo_cargo_v14.md,## DIMENSION: TIEMPO ##,paragraph,23,7,2214,2237
info_cubo_cargo_v14.md,"Notas generales:
- Permite ubicar en el tiempo la relación de los cargos con la UZ. Se pueden desglosar los datos según el año o mes: • MES: se incluyen los cargos existentes a fecha último día del mes seleccionado (si se trata de un mes e curso, se incluyen los cargos existentes a la fecha de la última carga). • AÑO: se acumulan los cargos existentes a fecha último día de todos los meses del año seleccionado (si año seleccionado es un año en curso, se acumulan los cargos existentes a fecha último día de los mese anteriores y para el mes en curso los cargos existentes a la fecha de la última carga).",paragraph,606,128,2239,2845
info_cubo_cargo_v14.md,## DIMENSION: Unidad ##,paragraph,23,7,2847,2870
info_cubo_cargo_v14.md,"Notas generales:
- Permite clasificar los datos en función de la unidad a la que están adscritos los cargos.",paragraph,108,21,2872,2980
info_cubo_cargo_v14.md,"=== MEDIDAS ===

** Número de cargos **
Número de órganos unipersonales de representación que ostentan cargos, entre otros, del Consejo de Dirección, de los Centros, de los Departamentos y de los Institutos Universitarios de Investigación propios de Universidad de Zaragoza.",sentence,274,48,0,274
info_cubo_cargo_v14.md,"=== DIMENSIONES ===

## DIMENSION: Cargo ##

Notas generales:
- Permite identificar los cargos existentes según su denominación.",sentence,128,23,274,402
info_cubo_cargo_v14.md,"Atributos:
• Importe Teórico:
Permite clasificar los cargos en función del importe del complemento retributivo que perciben por su desempeño.",sentence,141,23,404,545
info_cubo_cargo_v14.md,El importe teórico es complementario de la dimensión “remunerado”.,sentence,66,12,547,613
info_cubo_cargo_v14.md,">Aclaración: “No informado” indica que el cargo no conlleva remuneración o que una misma persona ocupa d
cargos y sólo es posible disfrutar de un complemento retributivo por el desempeño de cargos académicos.",sentence,208,38,614,822
info_cubo_cargo_v14.md,"• Reducción:
Permite clasificar los cargos en función de la reducción en horas lectivas anuales o en porcentaje, como consecuencia del desempeño del cargo.",sentence,155,27,824,979
info_cubo_cargo_v14.md,"• Tipo:
Permite agrupar los cargos existentes según su tipología.",sentence,65,12,981,1046
info_cubo_cargo_v14.md,"Ejemplos: Vicerrectores, Decanos, Directores de Departamento, Directores de IUI, Coordinadores de Grado, etc.",sentence,109,20,1048,1157
info_cubo_cargo_v14.md,"## DIMENSION: Centro ##

Notas generales:
- Permite clasificar los datos en función del centro al que están adscritos los cargos.",sentence,129,26,1158,1287
info_cubo_cargo_v14.md,"## DIMENSION: Departamento ##

Notas generales:
- Permite clasificar los datos en función del departamento al que están adscritos los cargos.",sentence,141,26,1289,1430
info_cubo_cargo_v14.md,"## DIMENSION: Fecha de actualización ##

Notas generales:
- Indica la fecha de la última recarga de datos.",sentence,106,23,1432,1538
info_cubo_cargo_v14.md,Habitualmente es el domingo anterior a la consulta de datos.,sentence,60,11,1540,1600
info_cubo_cargo_v14.md,"## DIMENSION: PAS/PDI ##

Notas generales:
- Permite agrupar los datos en función de si el cargo lo desempeña un PDI o un PAS.",sentence,126,29,1601,1727
info_cubo_cargo_v14.md,"## DIMENSION: Rango de Edad ##

Notas generales:
- Permite agrupar los rangos de edad de los cargos en función de su fecha de nacimiento.",sentence,137,30,1729,1866
info_cubo_cargo_v14.md,">Valores posibles: 20 años o menos, 21 a 30, 31 a 40, 41 a 50, 51 a 60, 60 años o más.",sentence,86,30,1868,1954
info_cubo_cargo_v14.md,"## DIMENSION: Remunerado ##

Notas generales:
- Permite clasificar los cargos en función de si perciben un complemento retributivo (S) o no (N) por su desempeño.",sentence,161,35,1956,2117
info_cubo_cargo_v14.md,"## DIMENSION: Sexo ##

Notas generales:
- Permite agrupar los cargos en función de su sexo.",sentence,91,21,2119,2210
info_cubo_cargo_v14.md,"## DIMENSION: TIEMPO ##

Notas generales:
- Permite ubicar en el tiempo la relación de los cargos con la UZ.",sentence,108,25,2212,2320
info_cubo_cargo_v14.md,"Se pueden desglosar los datos según el año o mes: • MES: se incluyen los cargos existentes a fecha último día del mes seleccionado (si se trata de un mes e curso, se incluyen los cargos existentes a la fecha de la última carga).",sentence,228,50,2322,2550
info_cubo_cargo_v14.md,"• AÑO: se acumulan los cargos existentes a fecha último día de todos los meses del año seleccionado (si año seleccionado es un año en curso, se acumulan los cargos existentes a fecha último día de los mese anteriores y para el mes en curso los cargos existentes a la fecha de la última carga).",sentence,293,60,2551,2844
info_cubo_cargo_v14.md,"## DIMENSION: Unidad ##

Notas generales:
- Permite clasificar los datos en función de la unidad a la que están adscritos los cargos.",sentence,133,28,2845,2978
info_cubo_docenciaAsignatura_v10.md,"=== MEDIDAS ===

** Número de asignaturas **
Número de asignaturas con docencia que figura en ODILE, planificada en el POD y aprobada por Consejo de Gobierno.

>Se incluyen asignaturas correspondientes a planes de estudios oficiales de grado, máster y titulaciones
anteriores al EEES, impartidas en centros propios de la UZ.

** Número de grupos por actividad formativa **
Recuento de grupos de docencia que figuran en ODILE, planificados en el POD y aprobados por Consejo de Gobierno.

>Nota: los grupos de docencia se refieren a asignaturas correspondientes a planes de estudios oficiales de
grado, máster y titulaciones anteriores al EEES, impartidas en centros propios de la UZ.

** Número de horas de encargo **
Recuento de horas de docencia que figuran en ODILE, planificados en el POD y aprobados por Consejo de Gobierno.

>Nota: las horas de docencia se refieren a asignaturas correspondientes a planes de estudios oficiales de grado,
máster y titulaciones anteriores al EEES, impartidas en centros propios de la UZ.",section,1025,190,0,1025
info_cubo_docenciaAsignatura_v10.md,=== DIMENSIONES ===,section,20,3,1026,1046
info_cubo_docenciaAsignatura_v10.md,"## DIMENSION: Asignatura ##

Notas generales:
- Permite clasificar los datos en función de la asignatura (código y denominación).

Atributos:
• Clase:
Permite clasificar los datos en función de la clase de asignatura, tal como viene identificada en el plan de estudios.

>Valores posibles: formación básica, obligatoria, optativa, libre elección, troncal, prácticas externas,
complementos de formación, actividades académicas complementarias.

• Departamento:
Permite clasificar los datos en función del (o de los) departamento/s encargado/s de la impartición de las asignaturas

• Docencia Externa (S/N):
Permite distinguir entre las asignaturas cuyo encargo o parte de él está asignado al área 996‐Áreas externas UZ (S) del resto (N).

• Nº grupos de docencia:
Permite clasificar los datos en función del número de grupos de docencia asignados a la asignatura.

• Número de créditos:
Permite clasificar los datos en función del número de créditos asignados a la asignatura.

• Origen Vínculo (S/N):
Permite clasificar las asignaturas en función de si la docencia se imparte en un grupo de matrícula de otra asignatura (S) o no (N).

>La primera de las asignaturas en esta situación sería la asignatura origen de vínculo (en la que no hay encargo
docente) y la segunda sería la de destino, que es sobre la que recae el encargo.

• Tipo de docencia:
Permite clasificar los datos en función del tipo de docencia impartida, de acuerdo con los siguientes valores posibles: clases magistrales, resolución de problemas y casos, trabajos, prácticas de laboratorio, prácticas especiales, prácticas externas curriculares, etc.

• Tipo de tratamiento:
Permite clasificar las asignaturas en función de la tipología de docencia.

>Valores posibles: normal, prácticas, TFG y TFM (desde 2018/19), asignaturas departamentales.

• Área:
Permite clasificar los datos en función del (o de las) área/s de conocimiento encargada/s de la impartición de las asignaturas.

>Nota: en el caso de estudios interuniversitarios, cuando la docencia de la asignatura no se imparte por
profesores de la UZ, figura el valor “Áreas externas UZ”.",section,2114,402,1047,3161
info_cubo_docenciaAsignatura_v10.md,"## DIMENSION: CURSO ACADÉMICO ##

Notas generales:
- Identifica los diferentes cursos académicos (por ejemplo 2018/19).

>Nota: el primer curso académico del que constan datos es el 2005/06.",section,191,38,3162,3353
info_cubo_docenciaAsignatura_v10.md,"## DIMENSION: Centro ##

Notas generales:
- Permite clasificar los datos en función del centro en que se imparte el plan de estudios al que pertenece la asignatura.

Atributos:
• Campus:
Permite clasificar los datos en función del campus en que se ubica el centro de impartición del plan de estudios al que pertenece la asignatura.

• Localidad:
Permite clasificar los datos en función de la localidad en que se ubica el centro de impartición del plan de estudios al que pertenece la asignatura.",section,496,94,3354,3850
info_cubo_docenciaAsignatura_v10.md,"## DIMENSION: Fecha de actualización ##

Notas generales:
- Indica la fecha de la última recarga de datos. Habitualmente se realiza el domingo anterior a la fecha de consulta de datos.",section,185,37,3851,4036
info_cubo_docenciaAsignatura_v10.md,"## DIMENSION: Titulación ##

Atributos:
• Estudio:
Permite clasificar los datos en función del estudio al que pertenece la asignatura. Observaciones:

>No es lo mismo “estudio” que “plan de estudios”.
>Bajo un mismo estudio pueden existir varios planes, bien porque se imparten en distintas localidades
(ejemplos: ADE, Enfermería, Magisterio, Medicina, etc.) o bien porque se ha modificado el plan de estudios, pero el estudio sigue siendo el mismo (ejemplos: másteres regulados por el RD 56/2005 que se renuevan en virtud del RD 1393/2007).

• Plan de Estudios:
Permite clasificar los datos en función del plan de estudios (código y denominación) al que pertenece la asignatura.

• Rama de Conocimiento:
Permite clasificar los datos en función de la Rama de Conocimiento (Artes y Humanidades, Ciencias, Ciencias Sociales y Jurídicas, Ciencias de la Salud, Ingeniería y Arquitectura) a la que está asignado el estudio al que pertenece la asignatura.

• Tipo de Estudio:
Permite identificar el tipo de estudio del plan al que pertenece la asignatura: grado, máster, licenciatura o equivalente, diplomatura o equivalente.",section,1121,218,4037,5158
info_cubo_docenciaAsignatura_v10.md,=== MEDIDAS ===,paragraph,15,3,0,15
info_cubo_docenciaAsignatura_v10.md,"** Número de asignaturas **
Número de asignaturas con docencia que figura en ODILE, planificada en el POD y aprobada por Consejo de Gobierno.",paragraph,141,28,17,158
info_cubo_docenciaAsignatura_v10.md,">Se incluyen asignaturas correspondientes a planes de estudios oficiales de grado, máster y titulaciones
anteriores al EEES, impartidas en centros propios de la UZ.",paragraph,164,28,160,324
info_cubo_docenciaAsignatura_v10.md,"** Número de grupos por actividad formativa **
Recuento de grupos de docencia que figuran en ODILE, planificados en el POD y aprobados por Consejo de Gobierno.",paragraph,159,31,326,485
info_cubo_docenciaAsignatura_v10.md,">Nota: los grupos de docencia se refieren a asignaturas correspondientes a planes de estudios oficiales de
grado, máster y titulaciones anteriores al EEES, impartidas en centros propios de la UZ.",paragraph,195,35,487,682
info_cubo_docenciaAsignatura_v10.md,"** Número de horas de encargo **
Recuento de horas de docencia que figuran en ODILE, planificados en el POD y aprobados por Consejo de Gobierno.",paragraph,144,30,684,828
info_cubo_docenciaAsignatura_v10.md,">Nota: las horas de docencia se refieren a asignaturas correspondientes a planes de estudios oficiales de grado,
máster y titulaciones anteriores al EEES, impartidas en centros propios de la UZ.",paragraph,194,35,830,1024
info_cubo_docenciaAsignatura_v10.md,=== DIMENSIONES ===,paragraph,19,3,1026,1045
info_cubo_docenciaAsignatura_v10.md,## DIMENSION: Asignatura ##,paragraph,27,7,1047,1074
info_cubo_docenciaAsignatura_v10.md,"Notas generales:
- Permite clasificar los datos en función de la asignatura (código y denominación).",paragraph,100,19,1076,1176
info_cubo_docenciaAsignatura_v10.md,"Atributos:
• Clase:
Permite clasificar los datos en función de la clase de asignatura, tal como viene identificada en el plan de estudios.",paragraph,138,27,1178,1316
info_cubo_docenciaAsignatura_v10.md,">Valores posibles: formación básica, obligatoria, optativa, libre elección, troncal, prácticas externas,
complementos de formación, actividades académicas complementarias.",paragraph,171,27,1318,1489
info_cubo_docenciaAsignatura_v10.md,"• Departamento:
Permite clasificar los datos en función del (o de los) departamento/s encargado/s de la impartición de las asignaturas",paragraph,134,23,1491,1625
info_cubo_docenciaAsignatura_v10.md,"• Docencia Externa (S/N):
Permite distinguir entre las asignaturas cuyo encargo o parte de él está asignado al área 996‐Áreas externas UZ (S) del resto (N).",paragraph,156,34,1627,1783
info_cubo_docenciaAsignatura_v10.md,"• Nº grupos de docencia:
Permite clasificar los datos en función del número de grupos de docencia asignados a la asignatura.",paragraph,124,23,1785,1909
info_cubo_docenciaAsignatura_v10.md,"• Número de créditos:
Permite clasificar los datos en función del número de créditos asignados a la asignatura.",paragraph,111,20,1911,2022
info_cubo_docenciaAsignatura_v10.md,"• Origen Vínculo (S/N):
Permite clasificar las asignaturas en función de si la docencia se imparte en un grupo de matrícula de otra asignatura (S) o no (N).",paragraph,156,36,2024,2180
info_cubo_docenciaAsignatura_v10.md,">La primera de las asignaturas en esta situación sería la asignatura origen de vínculo (en la que no hay encargo
docente) y la segunda sería la de destino, que es sobre la que recae el encargo.",paragraph,193,41,2182,2375
info_cubo_docenciaAsignatura_v10.md,"• Tipo de docencia:
Permite clasificar los datos en función del tipo de docencia impartida, de acuerdo con los siguientes valores posibles: clases magistrales, resolución de problemas y casos, trabajos, prácticas de laboratorio, prácticas especiales, prácticas externas curriculares, etc.",paragraph,288,49,2377,2665
info_cubo_docenciaAsignatura_v10.md,"• Tipo de tratamiento:
Permite clasificar las asignaturas en función de la tipología de docencia.",paragraph,97,17,2667,2764
info_cubo_docenciaAsignatura_v10.md,">Valores posibles: normal, prácticas, TFG y TFM (desde 2018/19), asignaturas departamentales.",paragraph,93,19,2766,2859
info_cubo_docenciaAsignatura_v10.md,"• Área:
Permite clasificar los datos en función del (o de las) área/s de conocimiento encargada/s de la impartición de las asignaturas.",paragraph,135,26,2861,2996
info_cubo_docenciaAsignatura_v10.md,">Nota: en el caso de estudios interuniversitarios, cuando la docencia de la asignatura no se imparte por
profesores de la UZ, figura el valor “Áreas externas UZ”.",paragraph,162,34,2998,3160
info_cubo_docenciaAsignatura_v10.md,## DIMENSION: CURSO ACADÉMICO ##,paragraph,32,8,3162,3194
info_cubo_docenciaAsignatura_v10.md,"Notas generales:
- Identifica los diferentes cursos académicos (por ejemplo 2018/19).",paragraph,85,15,3196,3281
info_cubo_docenciaAsignatura_v10.md,>Nota: el primer curso académico del que constan datos es el 2005/06.,paragraph,69,15,3283,3352
info_cubo_docenciaAsignatura_v10.md,## DIMENSION: Centro ##,paragraph,23,7,3354,3377
info_cubo_docenciaAsignatura_v10.md,"Notas generales:
- Permite clasificar los datos en función del centro en que se imparte el plan de estudios al que pertenece la asignatura.",paragraph,139,26,3379,3518
info_cubo_docenciaAsignatura_v10.md,"Atributos:
• Campus:
Permite clasificar los datos en función del campus en que se ubica el centro de impartición del plan de estudios al que pertenece la asignatura.",paragraph,165,31,3520,3685
info_cubo_docenciaAsignatura_v10.md,"• Localidad:
Permite clasificar los datos en función de la localidad en que se ubica el centro de impartición del plan de estudios al que pertenece la asignatura.",paragraph,162,30,3687,3849
info_cubo_docenciaAsignatura_v10.md,## DIMENSION: Fecha de actualización ##,paragraph,39,9,3851,3890
info_cubo_docenciaAsignatura_v10.md,"Notas generales:
- Indica la fecha de la última recarga de datos. Habitualmente se realiza el domingo anterior a la fecha de consulta de datos.",paragraph,143,28,3892,4035
info_cubo_docenciaAsignatura_v10.md,## DIMENSION: Titulación ##,paragraph,27,7,4037,4064
info_cubo_docenciaAsignatura_v10.md,"Atributos:
• Estudio:
Permite clasificar los datos en función del estudio al que pertenece la asignatura. Observaciones:",paragraph,120,21,4066,4186
info_cubo_docenciaAsignatura_v10.md,">No es lo mismo “estudio” que “plan de estudios”.
>Bajo un mismo estudio pueden existir varios planes, bien porque se imparten en distintas localidades
(ejemplos: ADE, Enfermería, Magisterio, Medicina, etc.) o bien porque se ha modificado el plan de estudios, pero el estudio sigue siendo el mismo (ejemplos: másteres regulados por el RD 56/2005 que se renuevan en virtud del RD 1393/2007).",paragraph,390,83,4188,4578
info_cubo_docenciaAsignatura_v10.md,"• Plan de Estudios:
Permite clasificar los datos en función del plan de estudios (código y denominación) al que pertenece la asignatura.",paragraph,136,26,4580,4716
info_cubo_docenciaAsignatura_v10.md,"• Rama de Conocimiento:
Permite clasificar los datos en función de la Rama de Conocimiento (Artes y Humanidades, Ciencias, Ciencias Sociales y Jurídicas, Ciencias de la Salud, Ingeniería y Arquitectura) a la que está asignado el estudio al que pertenece la asignatura.",paragraph,268,50,4718,4986
info_cubo_docenciaAsignatura_v10.md,"• Tipo de Estudio:
Permite identificar el tipo de estudio del plan al que pertenece la asignatura: grado, máster, licenciatura o equivalente, diplomatura o equivalente.",paragraph,168,31,4988,5156
info_cubo_docenciaAsignatura_v10.md,"=== MEDIDAS ===

** Número de asignaturas **
Número de asignaturas con docencia que figura en ODILE, planificada en el POD y aprobada por Consejo de Gobierno.",sentence,158,31,0,158
info_cubo_docenciaAsignatura_v10.md,">Se incluyen asignaturas correspondientes a planes de estudios oficiales de grado, máster y titulaciones
anteriores al EEES, impartidas en centros propios de la UZ.",sentence,164,28,158,322
info_cubo_docenciaAsignatura_v10.md,"** Número de grupos por actividad formativa **
Recuento de grupos de docencia que figuran en ODILE, planificados en el POD y aprobados por Consejo de Gobierno.",sentence,159,31,324,483
info_cubo_docenciaAsignatura_v10.md,">Nota: los grupos de docencia se refieren a asignaturas correspondientes a planes de estudios oficiales de
grado, máster y titulaciones anteriores al EEES, impartidas en centros propios de la UZ.",sentence,195,35,485,680
info_cubo_docenciaAsignatura_v10.md,"** Número de horas de encargo **
Recuento de horas de docencia que figuran en ODILE, planificados en el POD y aprobados por Consejo de Gobierno.",sentence,144,30,682,826
info_cubo_docenciaAsignatura_v10.md,">Nota: las horas de docencia se refieren a asignaturas correspondientes a planes de estudios oficiales de grado,
máster y titulaciones anteriores al EEES, impartidas en centros propios de la UZ.",sentence,194,35,828,1022
info_cubo_docenciaAsignatura_v10.md,"=== DIMENSIONES ===

## DIMENSION: Asignatura ##

Notas generales:
- Permite clasificar los datos en función de la asignatura (código y denominación).",sentence,150,29,1024,1174
info_cubo_docenciaAsignatura_v10.md,"Atributos:
• Clase:
Permite clasificar los datos en función de la clase de asignatura, tal como viene identificada en el plan de estudios.",sentence,138,27,1176,1314
info_cubo_docenciaAsignatura_v10.md,">Valores posibles: formación básica, obligatoria, optativa, libre elección, troncal, prácticas externas,
complementos de formación, actividades académicas complementarias.",sentence,171,27,1316,1487
info_cubo_docenciaAsignatura_v10.md,"• Departamento:
Permite clasificar los datos en función del (o de los) departamento/s encargado/s de la impartición de las asignaturas

• Docencia Externa (S/N):
Permite distinguir entre las asignaturas cuyo encargo o parte de él está asignado al área 996‐Áreas externas UZ (S) del resto (N).",sentence,292,57,1489,1781
info_cubo_docenciaAsignatura_v10.md,"• Nº grupos de docencia:
Permite clasificar los datos en función del número de grupos de docencia asignados a la asignatura.",sentence,124,23,1783,1907
info_cubo_docenciaAsignatura_v10.md,"• Número de créditos:
Permite clasificar los datos en función del número de créditos asignados a la asignatura.",sentence,111,20,1909,2020
info_cubo_docenciaAsignatura_v10.md,"• Origen Vínculo (S/N):
Permite clasificar las asignaturas en función de si la docencia se imparte en un grupo de matrícula de otra asignatura (S) o no (N).",sentence,156,36,2022,2178
info_cubo_docenciaAsignatura_v10.md,">La primera de las asignaturas en esta situación sería la asignatura origen de vínculo (en la que no hay encargo
docente) y la segunda sería la de destino, que es sobre la que recae el encargo.",sentence,193,41,2180,2373
info_cubo_docenciaAsignatura_v10.md,"• Tipo de docencia:
Permite clasificar los datos en función del tipo de docencia impartida, de acuerdo con los siguientes valores posibles: clases magistrales, resolución de problemas y casos, trabajos, prácticas de laboratorio, prácticas especiales, prácticas externas curriculares, etc.",sentence,288,49,2375,2663
info_cubo_docenciaAsignatura_v10.md,"• Tipo de tratamiento:
Permite clasificar las asignaturas en función de la tipología de docencia.",sentence,97,17,2665,2762
info_cubo_docenciaAsignatura_v10.md,">Valores posibles: normal, prácticas, TFG y TFM (desde 2018/19), asignaturas departamentales.",sentence,93,19,2764,2857
info_cubo_docenciaAsignatura_v10.md,"• Área:
Permite clasificar los datos en función del (o de las) área/s de conocimiento encargada/s de la impartición de las asignaturas.",sentence,135,26,2859,2994
info_cubo_docenciaAsignatura_v10.md,">Nota: en el caso de estudios interuniversitarios, cuando la docencia de la asignatura no se imparte por
profesores de la UZ, figura el valor “Áreas externas UZ”.",sentence,162,34,2996,3158
info_cubo_docenciaAsignatura_v10.md,"## DIMENSION: CURSO ACADÉMICO ##

Notas generales:
- Identifica los diferentes cursos académicos (por ejemplo 2018/19).",sentence,119,23,3160,3279
info_cubo_docenciaAsignatura_v10.md,>Nota: el primer curso académico del que constan datos es el 2005/06.,sentence,69,15,3281,3350
info_cubo_docenciaAsignatura_v10.md,"## DIMENSION: Centro ##

Notas generales:
- Permite clasificar los datos en función del centro en que se imparte el plan de estudios al que pertenece la asignatura.",sentence,164,33,3352,3516
info_cubo_docenciaAsignatura_v10.md,"Atributos:
• Campus:
Permite clasificar los datos en función del campus en que se ubica el centro de impartición del plan de estudios al que pertenece la asignatura.",sentence,165,31,3518,3683
info_cubo_docenciaAsignatura_v10.md,"• Localidad:
Permite clasificar los datos en función de la localidad en que se ubica el centro de impartición del plan de estudios al que pertenece la asignatura.",sentence,162,30,3685,3847
info_cubo_docenciaAsignatura_v10.md,"## DIMENSION: Fecha de actualización ##

Notas generales:
- Indica la fecha de la última recarga de datos.",sentence,106,23,3849,3955
info_cubo_docenciaAsignatura_v10.md,Habitualmente se realiza el domingo anterior a la fecha de consulta de datos.,sentence,77,14,3957,4034
info_cubo_docenciaAsignatura_v10.md,"## DIMENSION: Titulación ##

Atributos:
• Estudio:
Permite clasificar los datos en función del estudio al que pertenece la asignatura.",sentence,134,26,4035,4169
info_cubo_docenciaAsignatura_v10.md,"Observaciones:

>No es lo mismo “estudio” que “plan de estudios”.",sentence,65,17,4171,4236
info_cubo_docenciaAsignatura_v10.md,">Bajo un mismo estudio pueden existir varios planes, bien porque se imparten en distintas localidades
(ejemplos: ADE, Enfermería, Magisterio, Medicina, etc.)",sentence,157,31,4237,4394
info_cubo_docenciaAsignatura_v10.md,"o bien porque se ha modificado el plan de estudios, pero el estudio sigue siendo el mismo (ejemplos: másteres regulados por el RD 56/2005 que se renuevan en virtud del RD 1393/2007).",sentence,182,37,4395,4577
info_cubo_docenciaAsignatura_v10.md,"• Plan de Estudios:
Permite clasificar los datos en función del plan de estudios (código y denominación) al que pertenece la asignatura.",sentence,136,26,4578,4714
info_cubo_docenciaAsignatura_v10.md,"• Rama de Conocimiento:
Permite clasificar los datos en función de la Rama de Conocimiento (Artes y Humanidades, Ciencias, Ciencias Sociales y Jurídicas, Ciencias de la Salud, Ingeniería y Arquitectura) a la que está asignado el estudio al que pertenece la asignatura.",sentence,268,50,4716,4984
info_cubo_docenciaAsignatura_v10.md,"• Tipo de Estudio:
Permite identificar el tipo de estudio del plan al que pertenece la asignatura: grado, máster, licenciatura o equivalente, diplomatura o equivalente.",sentence,168,31,4986,5154
info_cubo_docenciaPDI_v11.md,"=== MEDIDAS ===

** Número de asignaturas **
Número de asignaturas impartidas en centros propios de la Universidad de Zaragoza, correspondientes a planes de estudios oficiales de grado, máster y titulaciones anteriores al EEES.

>Se incluye además la docencia tutorizada correspondiente a las asignaturas “especiales”, que son
siguientes: docencia reconocida al profesorado por la dirección -dos cursos académicos antes- de tesis, de trabajos fin de grado, de trabajos fin de máster, de proyectos fin de carrera, de trabajos académicamente dirigidos y de prácticas (de empresa, escolares o integradas).

>A partir del curso 2018/19 los trabajos fin de grado y máster y las prácticas dejan de considerarse
como asignaturas especiales y pasan a gestionar su encargo como cualquier otra asignatura.

** Número de profesores **
Número de profesores que imparten asignaturas relacionadas en la medida “número de asignatura

** Horas de docencia **
Número de horas de docencia correspondientes a la impartición en centros propios de la UZ de asignaturas correspondientes a planes de estudios oficiales de grado, máster y titulaciones anterior al EEES.

>A partir del curso 2018/19 los trabajos fin de grado y máster y las prácticas se contabilizan dentro
esta medida.

** Horas de asignaturas especiales **
Número de horas reconocidas al profesorado como asignaturas “especiales”, es decir: por la direcc -dos cursos académicos antes- de tesis, de trabajos fin de grado, de trabajos fin de máster, de proyectos fin de carrera, de trabajos académicamente dirigidos y de prácticas (de empresa, escolar o integradas).

>Los trabajos fin de grado y máster y las prácticas se contabilizan dentro de esta medida hasta el
curso 2017/18.",section,1724,311,0,1724
info_cubo_docenciaPDI_v11.md,=== DIMENSIONES ===,section,20,3,1725,1745
info_cubo_docenciaPDI_v11.md,"## DIMENSION: Asignatura ##

Notas generales:
- Permite clasificar los datos en función de la asignatura (código y denominación).

Atributos:
• Centro:
Permite clasificar los datos en función del centro en que se imparte el plan de estudios al que pertenece la asignatura.

>Nota: el centro del plan de estudios al que pertenece la asignatura no tiene por qué necesariamen
corresponderse con el centro del profesorado que imparte la asignatura.

• Clase:
Permite clasificar los datos en función de la clase de asignatura, tal como viene identificada en el pl de estudios.

>Valores posibles: formación básica, obligatoria, optativa, libre elección, troncal, prácticas externas
complementos de formación, actividades académicas complementarias, ESPECIAL. Observaciones sobre el valor “ESPECIAL”:

>Comprende la docencia reconocida al profesorado por la dirección -dos cursos académicos antes-
tesis, de trabajos fin de grado, de trabajos fin de máster, de proyectos fin de carrera, de trabajos académicamente dirigidos y de prácticas (de empresa, escolares o integradas).

>A partir del curso 2018/19 los trabajos fin de grado y máster y las prácticas dejan de considerarse
como asignaturas especiales y pasan a gestionar su encargo como cualquier otra asignatura.

• Origen Vínculo (S/N):
Permite clasificar las asignaturas en función de si la docencia se imparte en un grupo de matrícula d otra asignatura (S) o no (N).

>La primera de las asignaturas en esta situación sería la asignatura origen de vínculo (en la que no
encargo docente) y la segunda sería la de destino, que es sobre la que recae el encargo.

• Tipo de tratamiento:
Permite clasificar las asignaturas en función de la tipología de docencia.

>Valores posibles: normal, prácticas, TFG y TFM (desde 2018/19), asignaturas departamentales,
asignaturas sin docencia (a extinguir).",section,1846,347,1746,3592
info_cubo_docenciaPDI_v11.md,"## DIMENSION: CURSO ACADÉMICO ##

Notas generales:
- Identifica los diferentes cursos académicos (por ejemplo 2021/22).

>Nota: el primer curso académico del que constan datos es el 2005/06.",section,191,38,3593,3784
info_cubo_docenciaPDI_v11.md,"## DIMENSION: Contrato ##

Atributos:
• Asociado Sanitario (S/N):
Permite distinguir los datos en función de si la impartición de la docencia corresponde a asociados ciencias de la salud (S) o a otro tipo de profesorado (N).

• Dedicación:
Permite distinguir los datos en función del tipo de dedicación que tiene el profesorado encargado d la impartición de la docencia, y de las horas incluidas en esa dedicación.

>Valores posibles: tiempo completo, tiempo parcial, tiempo parcial 6 horas, tiempo parcial 4 horas,
tiempo parcial 3 horas, conjunta completa (es la dedicación de algunos profesores vinculados a instituciones sanitarias, distintos de los asociados de ciencias de la salud), conjunta parcial (es la dedicación de los asociados de ciencias de la salud), colaborador extraordinario.",section,796,152,3785,4581
info_cubo_docenciaPDI_v11.md,"## DIMENSION: Fecha de actualización ##

Notas generales:
- Indica la fecha de la última recarga de datos. Habitualmente se realiza el domingo anterior a la fech de consulta de datos.",section,184,37,4582,4766
info_cubo_docenciaPDI_v11.md,"## DIMENSION: Profesor ##

Atributos:
• Campus:
Permite clasificar los datos en función del campus en que se ubica el centro al que pertenecen los profesores encargados de la impartición de la docencia (a fecha 30 de junio del curso seleccionado, a la fecha fin de contrato del profesor, si ésta es anterior al 30 de junio del curso seleccionado).

>Nota: el centro del profesorado no tiene por qué coincidir necesariamente con el centro del plan
estudios al que pertenece la asignatura.

• Centro:
Permite clasificar los datos en función del centro al que pertenecen los profesores encargados de la impartición de la docencia (a fecha 30 de junio del curso seleccionado, o a la fecha fin de contrato d profesor, si ésta es anterior al 30 de junio del curso seleccionado).

>Nota: el centro del profesorado no tiene por qué coincidir necesariamente con el centro del plan
estudios al que pertenece la asignatura.

• Ctg/Crp/Esc:
Permite clasificar los datos en función de la categoría/cuerpo/escala a la que pertenecen los profesores encargados de la impartición de la docencia (a fecha 30 de junio del curso seleccionado, a la fecha fin de contrato del profesor, si ésta es anterior al 30 de junio del curso seleccionado).

• Departamento:
Permite clasificar los datos en función del departamento al que pertenecen los profesores encarga de la impartición de la docencia (a fecha 30 de junio del curso seleccionado, o a la fecha fin de contrato del profesor, si ésta es anterior al 30 de junio del curso seleccionado).

• Doctor (S/N):
Permite clasificar a los profesores encargados de la impartición de la docencia en función de si figur como Doctor en las bases de datos de personal (S) o no (N) (a fecha 30 de junio del curso seleccionado, o a la fecha fin de contrato del profesor, si ésta es anterior al 30 de junio del curso seleccionado).

• Localidad:
Permite clasificar a los profesores en función de la localidad en que se ubica el centro al que pertenecen los profesores encargados de la impartición de la docencia (a fecha 30 de junio del curs seleccionado, o a la fecha fin de contrato del profesor, si ésta es anterior al 30 de junio del curso seleccionado).

>Nota: el centro del profesorado no tiene por qué coincidir necesariamente con el centro del plan
estudios al que pertenece la asignatura.

• País Nacionalidad:
Permite clasificar a los profesores en función de su país de nacionalidad legal.

• Permanente (S/N):
Permite clasificar a los profesores en función de si tienen vinculación permanente con la Universi de Zaragoza (S) o no (N). Según la disposición adicional décima de los Estatutos de la UZ, “son profesores con vinculac permanente a la Universidad los funcionarios de los cuerpos docentes universitarios y los profeso contratados con carácter indefinido"". Por tanto se consideran permanentes: • Funcionarios de los cuerpos docentes universitarios: catedráticos de universidad, profeso titulares de universidad, catedráticos de escuelas universitarias y profesores titulares escuelas universitarias. • Profesores contratados con carácter indefinido: los que tienen régimen jurídico ""labora contrato con modalidades ""indefinido fijo"" o ""indefinido no fijo"".

• Rango de edad:
Permite clasificar a los profesores en función de su edad a fecha 30 de junio del curso seleccionado

>Valores posibles: 21-30, 31-40, 41-50, 51-60, >60.

• Sexo:
Permite clasificar a los profesores en función de su sexo.

• Área:
Permite clasificar los datos en función del área de conocimiento a la que están adscritos los profesores encargados de la impartición de la docencia (a fecha 30 de junio del curso seleccionado, a la fecha fin de contrato del profesor, si ésta es anterior al 30 de junio del curso seleccionado).",section,3737,710,4767,8504
info_cubo_docenciaPDI_v11.md,"## DIMENSION: Responsabilidad ##

Notas generales:
- Permite clasificar los datos en función del tipo de responsabilidad asumida por el profesor que imparte la asignatura. Valores posibles: coordinar docencia, impartir docencia, dirigir.",section,238,41,8505,8743
info_cubo_docenciaPDI_v11.md,"## DIMENSION: Tipo de docencia ##

Notas generales:
- Permite clasificar los datos en función del tipo de docencia impartida, de acuerdo con los siguiente valores posibles: clases magistrales, resolución de problemas y casos, trabajos, prácticas de laboratorio, prácticas especiales, prácticas externas curriculares, docencia tutorizada, etc.",section,343,60,8744,9087
info_cubo_docenciaPDI_v11.md,"## DIMENSION: Titulación ##

Atributos:
• Estudio:
Permite clasificar los datos en función del estudio al que pertenece la asignatura. Observaciones:

>No es lo mismo “estudio” que “plan de estudios”.
>Bajo un mismo estudio pueden existir varios planes, bien porque se imparten en distintas localida
(ejemplos: ADE, Enfermería, Magisterio, Medicina, etc.) o bien porque se ha modificado el plan de estudios, pero el estudio sigue siendo el mismo (ejemplos: másteres regulados por el RD 56/2005 q se renuevan en virtud del RD 1393/2007).

• Plan de Estudios:
Permite clasificar los datos en función del plan de estudios (código y denominación) al que pertene la asignatura.

>Estudio: es adecuado si queremos agrupar los datos de los estudios que se imparten en varias
localidades (ejemplo: ADE, Enfermería, Magisterio, Medicina, etc.)

• Rama de Conocimiento:
Permite clasificar los datos en función de la Rama de Conocimiento (Artes y Humanidades, Ciencias Ciencias Sociales y Jurídicas, Ciencias de la Salud, Ingeniería y Arquitectura) a la que está asignado e estudio al que pertenece la asignatura.

• Tipo de estudio:
Permite identificar el tipo de estudio del plan al que pertenece la asignatura: grado, máster, licenciatura o equivalente, diplomatura o equivalente.

>Nota: figuran como “no informado” los datos correspondientes a asignaturas del tipo “ESPECIAL”.",section,1371,270,9088,10459
info_cubo_docenciaPDI_v11.md,"## DIMENSION: Tramos ##

Atributos:
• Docencia Quinquenios:
Permite clasificar los datos en función del número de quinquenios o tramos de docencia que tienen reconocidos a efectos económicos los profesores encargados de la impartición de la docencia (a fec 30 de junio del curso seleccionado, o a la fecha fin de contrato del profesor, si ésta es anterior al 30 de junio del curso seleccionado).

• Gestión Trienios:
Permite clasificar los datos en función del número de trienios o tramos de gestión que tienen reconocidos a efectos económicos los profesores encargados de la impartición de la docencia (a fec 30 de junio del curso seleccionado, o a la fecha fin de contrato del profesor, si ésta es anterior al 30 de junio del curso seleccionado).

• Investigación Sexenios Estatales:
Permite clasificar los datos en función del número de sexenios o tramos de investigación reconocid por la CNEAI a los profesores encargados de la impartición de la docencia (a fecha 30 de junio del curso seleccionado, o a la fecha fin de contrato del profesor, si ésta es anterior al 30 de junio del cu seleccionado). Se incluyen tanto los cuerpos de funcionarios docentes universitarios como el personal contratado.

• Sexenios posibles:
Permite clasificar los datos en función del número de sexenios posibles calculados a los funcionario doctores encargados de la impartición de la docencia.

>Fórmula de cálculo: [año que se selecciona – (año de obtención del título de Doctor + 1)]/6
(redondeando al entero inferior)

>En aquellos casos que no está informada la fecha de obtención del título de Doctor, se establece
añadiendo a la fecha de nacimiento 32,97 años (es, a fecha noviembre de 2013, la media de edad d obtención del título de Doctor en la UZ de los empleados que sí tienen informada la fecha de obtención del título de Doctor).

>Al poderse solicitar sexenios con carácter retrospectivo (méritos de investigación realizados en
fechas anteriores a la obtención del título de doctor) existe la posibilidad de que el número de sexenios posibles sea inferior al número de sexenios conseguidos.",section,2092,387,10460,12552
info_cubo_docenciaPDI_v11.md,=== MEDIDAS ===,paragraph,15,3,0,15
info_cubo_docenciaPDI_v11.md,"** Número de asignaturas **
Número de asignaturas impartidas en centros propios de la Universidad de Zaragoza, correspondientes a planes de estudios oficiales de grado, máster y titulaciones anteriores al EEES.",paragraph,210,36,17,227
info_cubo_docenciaPDI_v11.md,">Se incluye además la docencia tutorizada correspondiente a las asignaturas “especiales”, que son
siguientes: docencia reconocida al profesorado por la dirección -dos cursos académicos antes- de tesis, de trabajos fin de grado, de trabajos fin de máster, de proyectos fin de carrera, de trabajos académicamente dirigidos y de prácticas (de empresa, escolares o integradas).",paragraph,373,67,229,602
info_cubo_docenciaPDI_v11.md,">A partir del curso 2018/19 los trabajos fin de grado y máster y las prácticas dejan de considerarse
como asignaturas especiales y pasan a gestionar su encargo como cualquier otra asignatura.",paragraph,191,33,604,795
info_cubo_docenciaPDI_v11.md,"** Número de profesores **
Número de profesores que imparten asignaturas relacionadas en la medida “número de asignatura",paragraph,120,21,797,917
info_cubo_docenciaPDI_v11.md,"** Horas de docencia **
Número de horas de docencia correspondientes a la impartición en centros propios de la UZ de asignaturas correspondientes a planes de estudios oficiales de grado, máster y titulaciones anterior al EEES.",paragraph,226,40,919,1145
info_cubo_docenciaPDI_v11.md,">A partir del curso 2018/19 los trabajos fin de grado y máster y las prácticas se contabilizan dentro
esta medida.",paragraph,114,22,1147,1261
info_cubo_docenciaPDI_v11.md,"** Horas de asignaturas especiales **
Número de horas reconocidas al profesorado como asignaturas “especiales”, es decir: por la direcc -dos cursos académicos antes- de tesis, de trabajos fin de grado, de trabajos fin de máster, de proyectos fin de carrera, de trabajos académicamente dirigidos y de prácticas (de empresa, escolar o integradas).",paragraph,345,67,1263,1608
info_cubo_docenciaPDI_v11.md,">Los trabajos fin de grado y máster y las prácticas se contabilizan dentro de esta medida hasta el
curso 2017/18.",paragraph,113,22,1610,1723
info_cubo_docenciaPDI_v11.md,=== DIMENSIONES ===,paragraph,19,3,1725,1744
info_cubo_docenciaPDI_v11.md,## DIMENSION: Asignatura ##,paragraph,27,7,1746,1773
info_cubo_docenciaPDI_v11.md,"Notas generales:
- Permite clasificar los datos en función de la asignatura (código y denominación).",paragraph,100,19,1775,1875
info_cubo_docenciaPDI_v11.md,"Atributos:
• Centro:
Permite clasificar los datos en función del centro en que se imparte el plan de estudios al que pertenece la asignatura.",paragraph,141,27,1877,2018
info_cubo_docenciaPDI_v11.md,">Nota: el centro del plan de estudios al que pertenece la asignatura no tiene por qué necesariamen
corresponderse con el centro del profesorado que imparte la asignatura.",paragraph,170,30,2020,2190
info_cubo_docenciaPDI_v11.md,"• Clase:
Permite clasificar los datos en función de la clase de asignatura, tal como viene identificada en el pl de estudios.",paragraph,125,25,2192,2317
info_cubo_docenciaPDI_v11.md,">Valores posibles: formación básica, obligatoria, optativa, libre elección, troncal, prácticas externas
complementos de formación, actividades académicas complementarias, ESPECIAL. Observaciones sobre el valor “ESPECIAL”:",paragraph,221,36,2319,2540
info_cubo_docenciaPDI_v11.md,">Comprende la docencia reconocida al profesorado por la dirección -dos cursos académicos antes-
tesis, de trabajos fin de grado, de trabajos fin de máster, de proyectos fin de carrera, de trabajos académicamente dirigidos y de prácticas (de empresa, escolares o integradas).",paragraph,274,50,2542,2816
info_cubo_docenciaPDI_v11.md,">A partir del curso 2018/19 los trabajos fin de grado y máster y las prácticas dejan de considerarse
como asignaturas especiales y pasan a gestionar su encargo como cualquier otra asignatura.",paragraph,191,33,2818,3009
info_cubo_docenciaPDI_v11.md,"• Origen Vínculo (S/N):
Permite clasificar las asignaturas en función de si la docencia se imparte en un grupo de matrícula d otra asignatura (S) o no (N).",paragraph,155,36,3011,3166
info_cubo_docenciaPDI_v11.md,">La primera de las asignaturas en esta situación sería la asignatura origen de vínculo (en la que no
encargo docente) y la segunda sería la de destino, que es sobre la que recae el encargo.",paragraph,189,40,3168,3357
info_cubo_docenciaPDI_v11.md,"• Tipo de tratamiento:
Permite clasificar las asignaturas en función de la tipología de docencia.",paragraph,97,17,3359,3456
info_cubo_docenciaPDI_v11.md,">Valores posibles: normal, prácticas, TFG y TFM (desde 2018/19), asignaturas departamentales,
asignaturas sin docencia (a extinguir).",paragraph,133,27,3458,3591
info_cubo_docenciaPDI_v11.md,## DIMENSION: CURSO ACADÉMICO ##,paragraph,32,8,3593,3625
info_cubo_docenciaPDI_v11.md,"Notas generales:
- Identifica los diferentes cursos académicos (por ejemplo 2021/22).",paragraph,85,15,3627,3712
info_cubo_docenciaPDI_v11.md,>Nota: el primer curso académico del que constan datos es el 2005/06.,paragraph,69,15,3714,3783
info_cubo_docenciaPDI_v11.md,## DIMENSION: Contrato ##,paragraph,25,7,3785,3810
info_cubo_docenciaPDI_v11.md,"Atributos:
• Asociado Sanitario (S/N):
Permite distinguir los datos en función de si la impartición de la docencia corresponde a asociados ciencias de la salud (S) o a otro tipo de profesorado (N).",paragraph,197,42,3812,4009
info_cubo_docenciaPDI_v11.md,"• Dedicación:
Permite distinguir los datos en función del tipo de dedicación que tiene el profesorado encargado d la impartición de la docencia, y de las horas incluidas en esa dedicación.",paragraph,188,34,4011,4199
info_cubo_docenciaPDI_v11.md,">Valores posibles: tiempo completo, tiempo parcial, tiempo parcial 6 horas, tiempo parcial 4 horas,
tiempo parcial 3 horas, conjunta completa (es la dedicación de algunos profesores vinculados a instituciones sanitarias, distintos de los asociados de ciencias de la salud), conjunta parcial (es la dedicación de los asociados de ciencias de la salud), colaborador extraordinario.",paragraph,379,69,4201,4580
info_cubo_docenciaPDI_v11.md,## DIMENSION: Fecha de actualización ##,paragraph,39,9,4582,4621
info_cubo_docenciaPDI_v11.md,"Notas generales:
- Indica la fecha de la última recarga de datos. Habitualmente se realiza el domingo anterior a la fech de consulta de datos.",paragraph,142,28,4623,4765
info_cubo_docenciaPDI_v11.md,## DIMENSION: Profesor ##,paragraph,25,7,4767,4792
info_cubo_docenciaPDI_v11.md,"Atributos:
• Campus:
Permite clasificar los datos en función del campus en que se ubica el centro al que pertenecen los profesores encargados de la impartición de la docencia (a fecha 30 de junio del curso seleccionado, a la fecha fin de contrato del profesor, si ésta es anterior al 30 de junio del curso seleccionado).",paragraph,320,63,4794,5114
info_cubo_docenciaPDI_v11.md,">Nota: el centro del profesorado no tiene por qué coincidir necesariamente con el centro del plan
estudios al que pertenece la asignatura.",paragraph,138,25,5116,5254
info_cubo_docenciaPDI_v11.md,"• Centro:
Permite clasificar los datos en función del centro al que pertenecen los profesores encargados de la impartición de la docencia (a fecha 30 de junio del curso seleccionado, o a la fecha fin de contrato d profesor, si ésta es anterior al 30 de junio del curso seleccionado).",paragraph,283,56,5256,5539
info_cubo_docenciaPDI_v11.md,">Nota: el centro del profesorado no tiene por qué coincidir necesariamente con el centro del plan
estudios al que pertenece la asignatura.",paragraph,138,25,5541,5679
info_cubo_docenciaPDI_v11.md,"• Ctg/Crp/Esc:
Permite clasificar los datos en función de la categoría/cuerpo/escala a la que pertenecen los profesores encargados de la impartición de la docencia (a fecha 30 de junio del curso seleccionado, a la fecha fin de contrato del profesor, si ésta es anterior al 30 de junio del curso seleccionado).",paragraph,309,57,5681,5990
info_cubo_docenciaPDI_v11.md,"• Departamento:
Permite clasificar los datos en función del departamento al que pertenecen los profesores encarga de la impartición de la docencia (a fecha 30 de junio del curso seleccionado, o a la fecha fin de contrato del profesor, si ésta es anterior al 30 de junio del curso seleccionado).",paragraph,294,56,5992,6286
info_cubo_docenciaPDI_v11.md,"• Doctor (S/N):
Permite clasificar a los profesores encargados de la impartición de la docencia en función de si figur como Doctor en las bases de datos de personal (S) o no (N) (a fecha 30 de junio del curso seleccionado, o a la fecha fin de contrato del profesor, si ésta es anterior al 30 de junio del curso seleccionado).",paragraph,325,73,6288,6613
info_cubo_docenciaPDI_v11.md,"• Localidad:
Permite clasificar a los profesores en función de la localidad en que se ubica el centro al que pertenecen los profesores encargados de la impartición de la docencia (a fecha 30 de junio del curs seleccionado, o a la fecha fin de contrato del profesor, si ésta es anterior al 30 de junio del curso seleccionado).",paragraph,325,64,6615,6940
info_cubo_docenciaPDI_v11.md,">Nota: el centro del profesorado no tiene por qué coincidir necesariamente con el centro del plan
estudios al que pertenece la asignatura.",paragraph,138,25,6942,7080
info_cubo_docenciaPDI_v11.md,"• País Nacionalidad:
Permite clasificar a los profesores en función de su país de nacionalidad legal.",paragraph,101,18,7082,7183
info_cubo_docenciaPDI_v11.md,"• Permanente (S/N):
Permite clasificar a los profesores en función de si tienen vinculación permanente con la Universi de Zaragoza (S) o no (N). Según la disposición adicional décima de los Estatutos de la UZ, “son profesores con vinculac permanente a la Universidad los funcionarios de los cuerpos docentes universitarios y los profeso contratados con carácter indefinido"". Por tanto se consideran permanentes: • Funcionarios de los cuerpos docentes universitarios: catedráticos de universidad, profeso titulares de universidad, catedráticos de escuelas universitarias y profesores titulares escuelas universitarias. • Profesores contratados con carácter indefinido: los que tienen régimen jurídico ""labora contrato con modalidades ""indefinido fijo"" o ""indefinido no fijo"".",paragraph,774,130,7185,7959
info_cubo_docenciaPDI_v11.md,"• Rango de edad:
Permite clasificar a los profesores en función de su edad a fecha 30 de junio del curso seleccionado",paragraph,117,23,7961,8078
info_cubo_docenciaPDI_v11.md,">Valores posibles: 21-30, 31-40, 41-50, 51-60, >60.",paragraph,51,15,8080,8131
info_cubo_docenciaPDI_v11.md,"• Sexo:
Permite clasificar a los profesores en función de su sexo.",paragraph,66,14,8133,8199
info_cubo_docenciaPDI_v11.md,"• Área:
Permite clasificar los datos en función del área de conocimiento a la que están adscritos los profesores encargados de la impartición de la docencia (a fecha 30 de junio del curso seleccionado, a la fecha fin de contrato del profesor, si ésta es anterior al 30 de junio del curso seleccionado).",paragraph,302,59,8201,8503
info_cubo_docenciaPDI_v11.md,## DIMENSION: Responsabilidad ##,paragraph,32,7,8505,8537
info_cubo_docenciaPDI_v11.md,"Notas generales:
- Permite clasificar los datos en función del tipo de responsabilidad asumida por el profesor que imparte la asignatura. Valores posibles: coordinar docencia, impartir docencia, dirigir.",paragraph,203,34,8539,8742
info_cubo_docenciaPDI_v11.md,## DIMENSION: Tipo de docencia ##,paragraph,33,9,8744,8777
info_cubo_docenciaPDI_v11.md,"Notas generales:
- Permite clasificar los datos en función del tipo de docencia impartida, de acuerdo con los siguiente valores posibles: clases magistrales, resolución de problemas y casos, trabajos, prácticas de laboratorio, prácticas especiales, prácticas externas curriculares, docencia tutorizada, etc.",paragraph,307,51,8779,9086
info_cubo_docenciaPDI_v11.md,## DIMENSION: Titulación ##,paragraph,27,7,9088,9115
info_cubo_docenciaPDI_v11.md,"Atributos:
• Estudio:
Permite clasificar los datos en función del estudio al que pertenece la asignatura. Observaciones:",paragraph,120,21,9117,9237
info_cubo_docenciaPDI_v11.md,">No es lo mismo “estudio” que “plan de estudios”.
>Bajo un mismo estudio pueden existir varios planes, bien porque se imparten en distintas localida
(ejemplos: ADE, Enfermería, Magisterio, Medicina, etc.) o bien porque se ha modificado el plan de estudios, pero el estudio sigue siendo el mismo (ejemplos: másteres regulados por el RD 56/2005 q se renuevan en virtud del RD 1393/2007).",paragraph,385,83,9239,9624
info_cubo_docenciaPDI_v11.md,"• Plan de Estudios:
Permite clasificar los datos en función del plan de estudios (código y denominación) al que pertene la asignatura.",paragraph,134,26,9626,9760
info_cubo_docenciaPDI_v11.md,">Estudio: es adecuado si queremos agrupar los datos de los estudios que se imparten en varias
localidades (ejemplo: ADE, Enfermería, Magisterio, Medicina, etc.)",paragraph,160,33,9762,9922
info_cubo_docenciaPDI_v11.md,"• Rama de Conocimiento:
Permite clasificar los datos en función de la Rama de Conocimiento (Artes y Humanidades, Ciencias Ciencias Sociales y Jurídicas, Ciencias de la Salud, Ingeniería y Arquitectura) a la que está asignado e estudio al que pertenece la asignatura.",paragraph,266,49,9924,10190
info_cubo_docenciaPDI_v11.md,"• Tipo de estudio:
Permite identificar el tipo de estudio del plan al que pertenece la asignatura: grado, máster, licenciatura o equivalente, diplomatura o equivalente.",paragraph,168,31,10192,10360
info_cubo_docenciaPDI_v11.md,>Nota: figuran como “no informado” los datos correspondientes a asignaturas del tipo “ESPECIAL”.,paragraph,96,20,10362,10458
info_cubo_docenciaPDI_v11.md,## DIMENSION: Tramos ##,paragraph,23,7,10460,10483
info_cubo_docenciaPDI_v11.md,"Atributos:
• Docencia Quinquenios:
Permite clasificar los datos en función del número de quinquenios o tramos de docencia que tienen reconocidos a efectos económicos los profesores encargados de la impartición de la docencia (a fec 30 de junio del curso seleccionado, o a la fecha fin de contrato del profesor, si ésta es anterior al 30 de junio del curso seleccionado).",paragraph,370,68,10485,10855
info_cubo_docenciaPDI_v11.md,"• Gestión Trienios:
Permite clasificar los datos en función del número de trienios o tramos de gestión que tienen reconocidos a efectos económicos los profesores encargados de la impartición de la docencia (a fec 30 de junio del curso seleccionado, o a la fecha fin de contrato del profesor, si ésta es anterior al 30 de junio del curso seleccionado).",paragraph,351,66,10857,11208
info_cubo_docenciaPDI_v11.md,"• Investigación Sexenios Estatales:
Permite clasificar los datos en función del número de sexenios o tramos de investigación reconocid por la CNEAI a los profesores encargados de la impartición de la docencia (a fecha 30 de junio del curso seleccionado, o a la fecha fin de contrato del profesor, si ésta es anterior al 30 de junio del cu seleccionado). Se incluyen tanto los cuerpos de funcionarios docentes universitarios como el personal contratado.",paragraph,452,80,11210,11662
info_cubo_docenciaPDI_v11.md,"• Sexenios posibles:
Permite clasificar los datos en función del número de sexenios posibles calculados a los funcionario doctores encargados de la impartición de la docencia.",paragraph,175,28,11664,11839
info_cubo_docenciaPDI_v11.md,">Fórmula de cálculo: [año que se selecciona – (año de obtención del título de Doctor + 1)]/6
(redondeando al entero inferior)",paragraph,125,30,11841,11966
info_cubo_docenciaPDI_v11.md,">En aquellos casos que no está informada la fecha de obtención del título de Doctor, se establece
añadiendo a la fecha de nacimiento 32,97 años (es, a fecha noviembre de 2013, la media de edad d obtención del título de Doctor en la UZ de los empleados que sí tienen informada la fecha de obtención del título de Doctor).",paragraph,320,66,11968,12288
info_cubo_docenciaPDI_v11.md,">Al poderse solicitar sexenios con carácter retrospectivo (méritos de investigación realizados en
fechas anteriores a la obtención del título de doctor) existe la posibilidad de que el número de sexenios posibles sea inferior al número de sexenios conseguidos.",paragraph,260,42,12290,12550
info_cubo_docenciaPDI_v11.md,"=== MEDIDAS ===

** Número de asignaturas **
Número de asignaturas impartidas en centros propios de la Universidad de Zaragoza, correspondientes a planes de estudios oficiales de grado, máster y titulaciones anteriores al EEES.",sentence,227,39,0,227
info_cubo_docenciaPDI_v11.md,">Se incluye además la docencia tutorizada correspondiente a las asignaturas “especiales”, que son
siguientes: docencia reconocida al profesorado por la dirección -dos cursos académicos antes- de tesis, de trabajos fin de grado, de trabajos fin de máster, de proyectos fin de carrera, de trabajos académicamente dirigidos y de prácticas (de empresa, escolares o integradas).",sentence,373,67,227,600
info_cubo_docenciaPDI_v11.md,">A partir del curso 2018/19 los trabajos fin de grado y máster y las prácticas dejan de considerarse
como asignaturas especiales y pasan a gestionar su encargo como cualquier otra asignatura.",sentence,191,33,602,793
info_cubo_docenciaPDI_v11.md,"** Número de profesores **
Número de profesores que imparten asignaturas relacionadas en la medida “número de asignatura

** Horas de docencia **
Número de horas de docencia correspondientes a la impartición en centros propios de la UZ de asignaturas correspondientes a planes de estudios oficiales de grado, máster y titulaciones anterior al EEES.",sentence,348,61,795,1143
info_cubo_docenciaPDI_v11.md,">A partir del curso 2018/19 los trabajos fin de grado y máster y las prácticas se contabilizan dentro
esta medida.",sentence,114,22,1145,1259
info_cubo_docenciaPDI_v11.md,"** Horas de asignaturas especiales **
Número de horas reconocidas al profesorado como asignaturas “especiales”, es decir: por la direcc -dos cursos académicos antes- de tesis, de trabajos fin de grado, de trabajos fin de máster, de proyectos fin de carrera, de trabajos académicamente dirigidos y de prácticas (de empresa, escolar o integradas).",sentence,345,67,1261,1606
info_cubo_docenciaPDI_v11.md,">Los trabajos fin de grado y máster y las prácticas se contabilizan dentro de esta medida hasta el
curso 2017/18.",sentence,113,22,1608,1721
info_cubo_docenciaPDI_v11.md,"=== DIMENSIONES ===

## DIMENSION: Asignatura ##

Notas generales:
- Permite clasificar los datos en función de la asignatura (código y denominación).",sentence,150,29,1723,1873
info_cubo_docenciaPDI_v11.md,"Atributos:
• Centro:
Permite clasificar los datos en función del centro en que se imparte el plan de estudios al que pertenece la asignatura.",sentence,141,27,1875,2016
info_cubo_docenciaPDI_v11.md,">Nota: el centro del plan de estudios al que pertenece la asignatura no tiene por qué necesariamen
corresponderse con el centro del profesorado que imparte la asignatura.",sentence,170,30,2018,2188
info_cubo_docenciaPDI_v11.md,"• Clase:
Permite clasificar los datos en función de la clase de asignatura, tal como viene identificada en el pl de estudios.",sentence,125,25,2190,2315
info_cubo_docenciaPDI_v11.md,">Valores posibles: formación básica, obligatoria, optativa, libre elección, troncal, prácticas externas
complementos de formación, actividades académicas complementarias, ESPECIAL.",sentence,180,28,2317,2497
info_cubo_docenciaPDI_v11.md,"Observaciones sobre el valor “ESPECIAL”:

>Comprende la docencia reconocida al profesorado por la dirección -dos cursos académicos antes-
tesis, de trabajos fin de grado, de trabajos fin de máster, de proyectos fin de carrera, de trabajos académicamente dirigidos y de prácticas (de empresa, escolares o integradas).",sentence,316,58,2499,2815
info_cubo_docenciaPDI_v11.md,">A partir del curso 2018/19 los trabajos fin de grado y máster y las prácticas dejan de considerarse
como asignaturas especiales y pasan a gestionar su encargo como cualquier otra asignatura.",sentence,191,33,2816,3007
info_cubo_docenciaPDI_v11.md,"• Origen Vínculo (S/N):
Permite clasificar las asignaturas en función de si la docencia se imparte en un grupo de matrícula d otra asignatura (S) o no (N).",sentence,155,36,3009,3164
info_cubo_docenciaPDI_v11.md,">La primera de las asignaturas en esta situación sería la asignatura origen de vínculo (en la que no
encargo docente) y la segunda sería la de destino, que es sobre la que recae el encargo.",sentence,189,40,3166,3355
info_cubo_docenciaPDI_v11.md,"• Tipo de tratamiento:
Permite clasificar las asignaturas en función de la tipología de docencia.",sentence,97,17,3357,3454
info_cubo_docenciaPDI_v11.md,">Valores posibles: normal, prácticas, TFG y TFM (desde 2018/19), asignaturas departamentales,
asignaturas sin docencia (a extinguir).",sentence,133,27,3456,3589
info_cubo_docenciaPDI_v11.md,"## DIMENSION: CURSO ACADÉMICO ##

Notas generales:
- Identifica los diferentes cursos académicos (por ejemplo 2021/22).",sentence,119,23,3591,3710
info_cubo_docenciaPDI_v11.md,>Nota: el primer curso académico del que constan datos es el 2005/06.,sentence,69,15,3712,3781
info_cubo_docenciaPDI_v11.md,"## DIMENSION: Contrato ##

Atributos:
• Asociado Sanitario (S/N):
Permite distinguir los datos en función de si la impartición de la docencia corresponde a asociados ciencias de la salud (S) o a otro tipo de profesorado (N).",sentence,224,49,3783,4007
info_cubo_docenciaPDI_v11.md,"• Dedicación:
Permite distinguir los datos en función del tipo de dedicación que tiene el profesorado encargado d la impartición de la docencia, y de las horas incluidas en esa dedicación.",sentence,188,34,4009,4197
info_cubo_docenciaPDI_v11.md,">Valores posibles: tiempo completo, tiempo parcial, tiempo parcial 6 horas, tiempo parcial 4 horas,
tiempo parcial 3 horas, conjunta completa (es la dedicación de algunos profesores vinculados a instituciones sanitarias, distintos de los asociados de ciencias de la salud), conjunta parcial (es la dedicación de los asociados de ciencias de la salud), colaborador extraordinario.",sentence,379,69,4199,4578
info_cubo_docenciaPDI_v11.md,"## DIMENSION: Fecha de actualización ##

Notas generales:
- Indica la fecha de la última recarga de datos.",sentence,106,23,4580,4686
info_cubo_docenciaPDI_v11.md,Habitualmente se realiza el domingo anterior a la fech de consulta de datos.,sentence,76,14,4688,4764
info_cubo_docenciaPDI_v11.md,"## DIMENSION: Profesor ##

Atributos:
• Campus:
Permite clasificar los datos en función del campus en que se ubica el centro al que pertenecen los profesores encargados de la impartición de la docencia (a fecha 30 de junio del curso seleccionado, a la fecha fin de contrato del profesor, si ésta es anterior al 30 de junio del curso seleccionado).",sentence,347,70,4765,5112
info_cubo_docenciaPDI_v11.md,">Nota: el centro del profesorado no tiene por qué coincidir necesariamente con el centro del plan
estudios al que pertenece la asignatura.",sentence,138,25,5114,5252
info_cubo_docenciaPDI_v11.md,"• Centro:
Permite clasificar los datos en función del centro al que pertenecen los profesores encargados de la impartición de la docencia (a fecha 30 de junio del curso seleccionado, o a la fecha fin de contrato d profesor, si ésta es anterior al 30 de junio del curso seleccionado).",sentence,283,56,5254,5537
info_cubo_docenciaPDI_v11.md,">Nota: el centro del profesorado no tiene por qué coincidir necesariamente con el centro del plan
estudios al que pertenece la asignatura.",sentence,138,25,5539,5677
info_cubo_docenciaPDI_v11.md,"• Ctg/Crp/Esc:
Permite clasificar los datos en función de la categoría/cuerpo/escala a la que pertenecen los profesores encargados de la impartición de la docencia (a fecha 30 de junio del curso seleccionado, a la fecha fin de contrato del profesor, si ésta es anterior al 30 de junio del curso seleccionado).",sentence,309,57,5679,5988
info_cubo_docenciaPDI_v11.md,"• Departamento:
Permite clasificar los datos en función del departamento al que pertenecen los profesores encarga de la impartición de la docencia (a fecha 30 de junio del curso seleccionado, o a la fecha fin de contrato del profesor, si ésta es anterior al 30 de junio del curso seleccionado).",sentence,294,56,5990,6284
info_cubo_docenciaPDI_v11.md,"• Doctor (S/N):
Permite clasificar a los profesores encargados de la impartición de la docencia en función de si figur como Doctor en las bases de datos de personal (S) o no (N) (a fecha 30 de junio del curso seleccionado, o a la fecha fin de contrato del profesor, si ésta es anterior al 30 de junio del curso seleccionado).",sentence,325,73,6286,6611
info_cubo_docenciaPDI_v11.md,"• Localidad:
Permite clasificar a los profesores en función de la localidad en que se ubica el centro al que pertenecen los profesores encargados de la impartición de la docencia (a fecha 30 de junio del curs seleccionado, o a la fecha fin de contrato del profesor, si ésta es anterior al 30 de junio del curso seleccionado).",sentence,325,64,6613,6938
info_cubo_docenciaPDI_v11.md,">Nota: el centro del profesorado no tiene por qué coincidir necesariamente con el centro del plan
estudios al que pertenece la asignatura.",sentence,138,25,6940,7078
info_cubo_docenciaPDI_v11.md,"• País Nacionalidad:
Permite clasificar a los profesores en función de su país de nacionalidad legal.",sentence,101,18,7080,7181
info_cubo_docenciaPDI_v11.md,"• Permanente (S/N):
Permite clasificar a los profesores en función de si tienen vinculación permanente con la Universi de Zaragoza (S) o no (N).",sentence,144,32,7183,7327
info_cubo_docenciaPDI_v11.md,"Según la disposición adicional décima de los Estatutos de la UZ, “son profesores con vinculac permanente a la Universidad los funcionarios de los cuerpos docentes universitarios y los profeso contratados con carácter indefinido"".",sentence,229,37,7329,7558
info_cubo_docenciaPDI_v11.md,"Por tanto se consideran permanentes: • Funcionarios de los cuerpos docentes universitarios: catedráticos de universidad, profeso titulares de universidad, catedráticos de escuelas universitarias y profesores titulares escuelas universitarias.",sentence,242,33,7559,7801
info_cubo_docenciaPDI_v11.md,"• Profesores contratados con carácter indefinido: los que tienen régimen jurídico ""labora contrato con modalidades ""indefinido fijo"" o ""indefinido no fijo"".",sentence,156,28,7802,7958
info_cubo_docenciaPDI_v11.md,"• Rango de edad:
Permite clasificar a los profesores en función de su edad a fecha 30 de junio del curso seleccionado

>Valores posibles: 21-30, 31-40, 41-50, 51-60, >60.",sentence,170,38,7959,8129
info_cubo_docenciaPDI_v11.md,"• Sexo:
Permite clasificar a los profesores en función de su sexo.",sentence,66,14,8131,8197
info_cubo_docenciaPDI_v11.md,"• Área:
Permite clasificar los datos en función del área de conocimiento a la que están adscritos los profesores encargados de la impartición de la docencia (a fecha 30 de junio del curso seleccionado, a la fecha fin de contrato del profesor, si ésta es anterior al 30 de junio del curso seleccionado).",sentence,302,59,8199,8501
info_cubo_docenciaPDI_v11.md,"## DIMENSION: Responsabilidad ##

Notas generales:
- Permite clasificar los datos en función del tipo de responsabilidad asumida por el profesor que imparte la asignatura.",sentence,171,30,8503,8674
info_cubo_docenciaPDI_v11.md,"Valores posibles: coordinar docencia, impartir docencia, dirigir.",sentence,65,11,8676,8741
info_cubo_docenciaPDI_v11.md,"## DIMENSION: Tipo de docencia ##

Notas generales:
- Permite clasificar los datos en función del tipo de docencia impartida, de acuerdo con los siguiente valores posibles: clases magistrales, resolución de problemas y casos, trabajos, prácticas de laboratorio, prácticas especiales, prácticas externas curriculares, docencia tutorizada, etc.",sentence,342,60,8742,9084
info_cubo_docenciaPDI_v11.md,"## DIMENSION: Titulación ##

Atributos:
• Estudio:
Permite clasificar los datos en función del estudio al que pertenece la asignatura.",sentence,134,26,9086,9220
info_cubo_docenciaPDI_v11.md,"Observaciones:

>No es lo mismo “estudio” que “plan de estudios”.",sentence,65,17,9222,9287
info_cubo_docenciaPDI_v11.md,">Bajo un mismo estudio pueden existir varios planes, bien porque se imparten en distintas localida
(ejemplos: ADE, Enfermería, Magisterio, Medicina, etc.)",sentence,154,31,9288,9442
info_cubo_docenciaPDI_v11.md,"o bien porque se ha modificado el plan de estudios, pero el estudio sigue siendo el mismo (ejemplos: másteres regulados por el RD 56/2005 q se renuevan en virtud del RD 1393/2007).",sentence,180,37,9443,9623
info_cubo_docenciaPDI_v11.md,"• Plan de Estudios:
Permite clasificar los datos en función del plan de estudios (código y denominación) al que pertene la asignatura.",sentence,134,26,9624,9758
info_cubo_docenciaPDI_v11.md,">Estudio: es adecuado si queremos agrupar los datos de los estudios que se imparten en varias
localidades (ejemplo: ADE, Enfermería, Magisterio, Medicina, etc.)",sentence,160,33,9760,9920
info_cubo_docenciaPDI_v11.md,"• Rama de Conocimiento:
Permite clasificar los datos en función de la Rama de Conocimiento (Artes y Humanidades, Ciencias Ciencias Sociales y Jurídicas, Ciencias de la Salud, Ingeniería y Arquitectura) a la que está asignado e estudio al que pertenece la asignatura.",sentence,266,49,9922,10188
info_cubo_docenciaPDI_v11.md,"• Tipo de estudio:
Permite identificar el tipo de estudio del plan al que pertenece la asignatura: grado, máster, licenciatura o equivalente, diplomatura o equivalente.",sentence,168,31,10190,10358
info_cubo_docenciaPDI_v11.md,>Nota: figuran como “no informado” los datos correspondientes a asignaturas del tipo “ESPECIAL”.,sentence,96,20,10360,10456
info_cubo_docenciaPDI_v11.md,"## DIMENSION: Tramos ##

Atributos:
• Docencia Quinquenios:
Permite clasificar los datos en función del número de quinquenios o tramos de docencia que tienen reconocidos a efectos económicos los profesores encargados de la impartición de la docencia (a fec 30 de junio del curso seleccionado, o a la fecha fin de contrato del profesor, si ésta es anterior al 30 de junio del curso seleccionado).",sentence,395,75,10458,10853
info_cubo_docenciaPDI_v11.md,"• Gestión Trienios:
Permite clasificar los datos en función del número de trienios o tramos de gestión que tienen reconocidos a efectos económicos los profesores encargados de la impartición de la docencia (a fec 30 de junio del curso seleccionado, o a la fecha fin de contrato del profesor, si ésta es anterior al 30 de junio del curso seleccionado).",sentence,351,66,10855,11206
info_cubo_docenciaPDI_v11.md,"• Investigación Sexenios Estatales:
Permite clasificar los datos en función del número de sexenios o tramos de investigación reconocid por la CNEAI a los profesores encargados de la impartición de la docencia (a fecha 30 de junio del curso seleccionado, o a la fecha fin de contrato del profesor, si ésta es anterior al 30 de junio del cu seleccionado).",sentence,353,66,11208,11561
info_cubo_docenciaPDI_v11.md,Se incluyen tanto los cuerpos de funcionarios docentes universitarios como el personal contratado.,sentence,98,14,11563,11661
info_cubo_docenciaPDI_v11.md,"• Sexenios posibles:
Permite clasificar los datos en función del número de sexenios posibles calculados a los funcionario doctores encargados de la impartición de la docencia.",sentence,175,28,11662,11837
info_cubo_docenciaPDI_v11.md,">Fórmula de cálculo: [año que se selecciona – (año de obtención del título de Doctor + 1)]/6
(redondeando al entero inferior)

>En aquellos casos que no está informada la fecha de obtención del título de Doctor, se establece
añadiendo a la fecha de nacimiento 32,97 años (es, a fecha noviembre de 2013, la media de edad d obtención del título de Doctor en la UZ de los empleados que sí tienen informada la fecha de obtención del título de Doctor).",sentence,447,96,11839,12286
info_cubo_docenciaPDI_v11.md,">Al poderse solicitar sexenios con carácter retrospectivo (méritos de investigación realizados en
fechas anteriores a la obtención del título de doctor) existe la posibilidad de que el número de sexenios posibles sea inferior al número de sexenios conseguidos.",sentence,260,42,12288,12548
info_cubo_egresados_v23.md,"=== MEDIDAS ===

** Alumnos graduados **
Número de estudiantes que han completado todos los créditos del plan de estudios, sin tener en cuenta si han solicitado o no el título. Notas:

>Para ser considerado graduado, un estudiante debe completar no sólo el número total de créditos de un plan
de estudios, sino los créditos mínimos de cada tipo de asignatura (básicos, obligatorios, optativos, etc.)

>Aclaración referente al tipo de estudio Doctorado: no se incluyen los programas de doctorado regulados por
los RD 185/1985 y 778/1998.

>Si se quiere obtener el número de alumnos graduados correspondientes al tipo de estudio Doctorado por curso
académico, el curso que se indica es aquél en que el doctorando lee su tesis doctoral.

** Alumnos que interrumpen sus estudios **
Número de estudiantes de un estudio que, sin obtener el título ni trasladarse a otra universidad, no se matriculan durante dos años consecutivos.

>Nota: se identifica con los tipos de egreso “abandono voluntario” (el expediente queda abierto), “régimen de
permanencia” y “cambio de estudios sin simultaneidad”.

** Alumnos que interrumpen sus estudios el primer año **
Es un caso particular de la medida “alumnos que interrumpen sus estudios”, siendo los dos años consecutivos de no matrícula los dos siguientes al año de acceso del estudiante al estudio.

** Alumnos que se trasladan a otra universidad **
Número de estudiantes de un plan de estudios a los que se les cierra el expediente por traslado a otra universidad o centro.

** Duración media en años de los graduados **
Media de los años que tardan los alumnos graduados en superar sus estudios.

>Cálculo de la duración: año de la graduación – año de acceso + 1
>Criterios de cálculo:
a) Se excluyen los alumnos de cursos de adaptación a grados. b) Se excluyen los alumnos que tengan reconocidos (o adaptados o convalidados) más del 15% de los créditos del plan de estudios. c) Se excluyen los alumnos acogidos a la modalidad de tiempo parcial en alguno de los años cursados.

** Media de cursos matriculados **
Calcula el promedio de cursos en que se han matriculado los estudiantes egresados en un estudio, cualquiera que sea el tipo de egreso (graduado, abandono, traslado).

>Nota: si quiere obtenerse la media de cursos matriculados por los graduados deberá seleccionarse la dimensión
""tipo de egreso"", filtrando ésta por el valor ""Graduado"".

** Media de créditos matriculados **
Es el promedio de la totalidad de créditos en que se han matriculado los estudiantes egresados en un estudio, cualquiera que sea el tipo de egreso (graduado, abandono, traslado).

>Nota: si quiere obtenerse la media de créditos matriculados por los graduados deberá seleccionarse la
dimensión ""tipo de egreso"", filtrando ésta por el valor ""Graduado"".

** Tasa de Eficiencia (*) **
Relación porcentual entre el número total de créditos que han superado el conjunto de graduados de un determinado año académico a lo largo del estudio en el que se han titulado y el número total de créditos en que se han matriculado. Observaciones:

>Se excluyen los estudiantes de cursos de adaptación a grados.
>Se excluyen los estudiantes que tengan reconocidos (o adaptados o convalidados) más del 15% de los créditos
del plan de estudios.",section,3250,639,0,3250
info_cubo_egresados_v23.md,=== DIMENSIONES ===,section,20,3,3251,3271
info_cubo_egresados_v23.md,"## DIMENSION: Acceso ##

Atributos:
• Estudio previo:
Identifica la clase de estudio cursado anteriormente por los estudiantes, que les da acceso a la Universidad, de acuerdo con los requisitos establecidos por la legislación vigente.

>Valores posibles: Pruebas de Acceso, COU sin PAU, FP, Titulados Universitarios, Mayores de 25, Mayores de 40,
Mayores de 45.

>Los estudiantes procedentes de Bachillerato se incluyen en “Pruebas de Acceso”. Los estudiantes procedentes
de Ciclos Formativos de Grado Superior se incluyen en “FP”, aunque se hayan presentado a la fase específica de la EvAU.

>Nota: el valor “No informado” se aplica a estudiantes procedentes de adaptaciones por extinción de planes de
estudios o que no han accedido a la titulación por procedimientos de preinscripción.",section,788,150,3272,4060
info_cubo_egresados_v23.md,"## DIMENSION: Alumno ##

Atributos:
• País Nacionalidad:
Permite clasificar los datos en función del país de nacionalidad legal de los estudiantes.

• Rango de Edad:
Permite agrupar los rangos de edad de los estudiantes en función de su edad a 31 de diciembre del curso académico seleccionado.

>Valores posibles: 18 años o menos, 19, 20, 21, 22, 23, 24, 25, 26, 27, 28, 29, 30 a 34, 35 a 39, 40 a 44, 45 a 49,
50 a 54, 55 a 59, 60 a 64, 65 años o más.

• Residencia Familiar:
Identifica el país, la comunidad autónoma, la provincia o la población de residencia familiar indicada por el estudiante en el curso académico en que se egresa.

• Sexo:
Permite agrupar los estudiantes en función de su sexo.",section,702,166,4061,4763
info_cubo_egresados_v23.md,"## DIMENSION: CURSO ACADÉMICO ##

Notas generales:
- Identifica los diferentes cursos académicos (por ejemplo 2023/24).

>Si se quiere consultar el número de egresados por curso académico, el curso es aquél en que el estudiante
supera los créditos necesarios para la obtención del título.

>En el caso de los egresados en estudios de doctorado, el curso académico de obtención del título es el de lectura
de la tesis doctoral.",section,427,82,4764,5191
info_cubo_egresados_v23.md,"## DIMENSION: Centro Egreso ##

Notas generales:
- Permite clasificar los datos en función del centro (código y denominación) en que egresan los estudiantes.

Atributos:
• Localidad:
Permite clasificar los datos en función de la localidad a la que pertenece el centro en que egresan los estudiantes.

• Tipo:
Permite clasificar los datos en función del tipo de centro (facultad, escuela universitaria, centro adscrito, etc.) en que egresan los estudiantes.",section,457,88,5192,5649
info_cubo_egresados_v23.md,"## DIMENSION: Centro Origen ##

Notas generales:
- Permite clasificar los datos en función del centro (código y denominación) en que el estudiante comenzó los estudios en los que egresa.

>Nota: el centro de egreso y el centro de origen coincidirá cuando el estudiante haya cursado un estudio en el
mismo centro desde el curso académico de acceso hasta el de egreso. Sin embargo no coincidirán cuando haya habido un traslado de expediente para continuar estudios o un cambio de denominación del centro.

Atributos:
• Localidad:
Permite clasificar los datos en función de la localidad a la que pertenece el centro en que el estudiante comenzó los estudios en los que egresa.",section,674,126,5650,6324
info_cubo_egresados_v23.md,"## DIMENSION: Egreso ##

Atributos:
• Abandono Inicial (S/N):
Permite distinguir los estudiantes que han interrumpido sus estudios el primer año (S: dos años consecutivos sin matrícula después del de acceso al estudio) del resto (N).

>Nota: se recomienda cruzar esta dimensión con la medida ""alumnos que interrumpen sus estudios"".

• Créditos Matriculados:
Permite clasificar los datos en función del rango de créditos matriculados por los estudiantes egresados (cualquiera que sea su tipo de egreso: graduado, abandono, traslado).

• Créditos Necesarios:
Permite clasificar los datos en función del rango de créditos necesarios que el estudiante debe superar para finalizar el estudio.

• Créditos Reconocidos:
Permite clasificar los datos en función del rango de créditos reconocidos por los estudiantes egresados (cualquiera que sea su tipo de egreso: graduado, abandono, traslado).

• Créditos Superados:
Permite clasificar los datos en función del rango de créditos superados por los estudiantes egresados (cualquiera que sea su tipo de egreso: graduado, abandono, traslado).

• Curso más alto matriculado:
Identifica el máximo curso en que el estudiante egresado (cualquiera que sea su tipo de egreso: graduado, abandono, traslado) ha llegado a tener asignaturas matriculadas.

>Nota: el valor 0 se corresponde con asignaturas de Programas de Doctorado, Proyectos Fin de Carrera,
asignaturas no asociadas a curso, sino a ciclo, y asignaturas matriculadas por estudiantes de Programas de Intercambio que vienen a la UZ.

• Número de años cursados:
Permite clasificar los datos en función del número de años matriculados por los estudiantes que se egresan en el curso académico seleccionado (cualquiera que sea su tipo de egreso: graduado, abandono, traslado).

>Nota: se contabiliza como año cursado si al menos el estudiante se matricula en una asignatura. Si en un año
académico reconoce créditos pero no matricula ninguno, no se contabiliza como año cursado.

• Solicita título (S/N):
Identifica si el estudiante ha solicitado el título (S) o no (N).

• Tipo de Egreso:
Clasifica a los estudiantes en función de la causa de su egreso: graduado, abandono voluntario (dos años consecutivos sin matrícula), incumplimiento de la normativa del régimen de permanencia, cambio de estudios sin simultaneidad, traslado a otra universidad.",section,2339,436,6325,8664
info_cubo_egresados_v23.md,"## DIMENSION: Fecha de actualización ##

Notas generales:
- Indica la fecha de la última recarga de datos. Habitualmente es el sábado anterior a la consulta de datos.",section,167,34,8665,8832
info_cubo_egresados_v23.md,"## DIMENSION: Movilidad ##

Atributos:
• Internacional:
Identifica si los estudiantes egresados (cualquiera que sea su tipo de egreso: graduado, abandono, traslado) han realizado en alguno de los años en que han estado matriculados una estancia en una universidad extranjera (S) o no (N), en el marco de los acuerdos bilaterales o programas de movilidad internacionales.",section,371,72,8833,9204
info_cubo_egresados_v23.md,"## DIMENSION: Movilidad: Programa ##

Notas generales:
- Identifica el tipo de Programa Internacional o la denominación del mismo, en caso de que los estudiantes egresados (cualquiera que sea su tipo de egreso: graduado, abandono, traslado) hayan realizado en alguno de los años en que ha estado matriculado una estancia en una universidad extranjera, en el marco de los acuerdos bilaterales o programas de movilidad internacionales, según el programa de intercambio cursado.

>Valores posibles Tipo Programa de Movilidad: Erasmus, Otras Dentro de la UE, Otras Fuera de la UE.
>Valores posibles Programa de Movilidad: Erasmus, Movilidad Iberoamérica, UZ/Norteamérica, Oceanía y Asia,
Movilidad UE-Suiza, etc.

>En el caso de no haberse realizado estancia de movilidad, se indica “No Informado”.",section,795,150,9205,10000
info_cubo_egresados_v23.md,"## DIMENSION: Titulación ##

Atributos:
• Duración oficial:
Permite clasificar los datos en función de la duración oficial (en años) del estudio en que egresan los estudiantes.

>Valores posibles: 1, 2, 3, 4, 5, 6.
>Los programas de doctorado no tienen una duración establecida y figuran con el valor 0.

• Estudio:
Permite identificar el estudio cursado por los estudiantes egresados. Observaciones:

>No es lo mismo “estudio” que “plan de estudios”.
>Bajo un mismo estudio pueden existir varios planes, bien porque se imparten en distintas localidades (ejemplos:
ADE, Enfermería, Magisterio, Medicina, etc.) o bien porque se ha modificado el plan de estudios, pero el estudio sigue siendo el mismo (ejemplos: másteres regulados por el RD 56/2005 que se renuevan en virtud del RD 1393/2007).

• Múltiple titulación (S/N):
Permite identificar a los estudiantes egresados en estudios que forman parte de una múltiple titulación (S).

>Ejemplo: egresados en las titulaciones de Derecho o ADE cuando éstas han sido cursadas como parte de la
Programación Conjunta Derecho-ADE.

• Plan de Estudios:
Permite identificar el plan de estudios (código y denominación) cursado por los estudiantes egresados.

• Rama de Conocimiento:
Permite clasificar los datos en función de la Rama de Conocimiento (Artes y Humanidades, Ciencias, Ciencias Sociales y Jurídicas, Ciencias de la Salud, Ingeniería y Arquitectura) a la que pertenece el estudio en que egresan los estudiantes.

• Tipo de estudio:
Permite identificar el tipo de estudio cursado por los estudiantes egresados: grado, máster, doctorado, licenciatura o equivalente, diplomatura o equivalente.",section,1642,318,10001,11643
info_cubo_egresados_v23.md,"## DIMENSION: Traslado ##

Atributos:
• Centro:
Identifica la universidad y el centro al que se trasladan los estudiantes a los que se cierra el expediente por traslado a otra universidad o centro.

>Nota: se recomienda cruzar esta dimensión con la medida ""alumnos que se trasladan a otra universidad"".

• Estudio:
Identifica el estudio al que trasladan los estudiantes a los que se cierra el expediente por traslado a otra universidad o centro.

>Nota: se recomienda cruzar esta dimensión con la medida ""alumnos que se trasladan a otra universidad"".",section,552,107,11644,12196
info_cubo_egresados_v23.md,=== MEDIDAS ===,paragraph,15,3,0,15
info_cubo_egresados_v23.md,"** Alumnos graduados **
Número de estudiantes que han completado todos los créditos del plan de estudios, sin tener en cuenta si han solicitado o no el título. Notas:",paragraph,166,34,17,183
info_cubo_egresados_v23.md,">Para ser considerado graduado, un estudiante debe completar no sólo el número total de créditos de un plan
de estudios, sino los créditos mínimos de cada tipo de asignatura (básicos, obligatorios, optativos, etc.)",paragraph,214,42,185,399
info_cubo_egresados_v23.md,">Aclaración referente al tipo de estudio Doctorado: no se incluyen los programas de doctorado regulados por
los RD 185/1985 y 778/1998.",paragraph,135,24,401,536
info_cubo_egresados_v23.md,">Si se quiere obtener el número de alumnos graduados correspondientes al tipo de estudio Doctorado por curso
académico, el curso que se indica es aquél en que el doctorando lee su tesis doctoral.",paragraph,195,36,538,733
info_cubo_egresados_v23.md,"** Alumnos que interrumpen sus estudios **
Número de estudiantes de un estudio que, sin obtener el título ni trasladarse a otra universidad, no se matriculan durante dos años consecutivos.",paragraph,188,35,735,923
info_cubo_egresados_v23.md,">Nota: se identifica con los tipos de egreso “abandono voluntario” (el expediente queda abierto), “régimen de
permanencia” y “cambio de estudios sin simultaneidad”.",paragraph,164,35,925,1089
info_cubo_egresados_v23.md,"** Alumnos que interrumpen sus estudios el primer año **
Es un caso particular de la medida “alumnos que interrumpen sus estudios”, siendo los dos años consecutivos de no matrícula los dos siguientes al año de acceso del estudiante al estudio.",paragraph,243,47,1091,1334
info_cubo_egresados_v23.md,"** Alumnos que se trasladan a otra universidad **
Número de estudiantes de un plan de estudios a los que se les cierra el expediente por traslado a otra universidad o centro.",paragraph,174,35,1336,1510
info_cubo_egresados_v23.md,"** Duración media en años de los graduados **
Media de los años que tardan los alumnos graduados en superar sus estudios.",paragraph,121,25,1512,1633
info_cubo_egresados_v23.md,">Cálculo de la duración: año de la graduación – año de acceso + 1
>Criterios de cálculo:
a) Se excluyen los alumnos de cursos de adaptación a grados. b) Se excluyen los alumnos que tengan reconocidos (o adaptados o convalidados) más del 15% de los créditos del plan de estudios. c) Se excluyen los alumnos acogidos a la modalidad de tiempo parcial en alguno de los años cursados.",paragraph,379,81,1635,2014
info_cubo_egresados_v23.md,"** Media de cursos matriculados **
Calcula el promedio de cursos en que se han matriculado los estudiantes egresados en un estudio, cualquiera que sea el tipo de egreso (graduado, abandono, traslado).",paragraph,200,40,2016,2216
info_cubo_egresados_v23.md,">Nota: si quiere obtenerse la media de cursos matriculados por los graduados deberá seleccionarse la dimensión
""tipo de egreso"", filtrando ésta por el valor ""Graduado"".",paragraph,168,33,2218,2386
info_cubo_egresados_v23.md,"** Media de créditos matriculados **
Es el promedio de la totalidad de créditos en que se han matriculado los estudiantes egresados en un estudio, cualquiera que sea el tipo de egreso (graduado, abandono, traslado).",paragraph,215,43,2388,2603
info_cubo_egresados_v23.md,">Nota: si quiere obtenerse la media de créditos matriculados por los graduados deberá seleccionarse la
dimensión ""tipo de egreso"", filtrando ésta por el valor ""Graduado"".",paragraph,170,33,2605,2775
info_cubo_egresados_v23.md,"** Tasa de Eficiencia (*) **
Relación porcentual entre el número total de créditos que han superado el conjunto de graduados de un determinado año académico a lo largo del estudio en el que se han titulado y el número total de créditos en que se han matriculado. Observaciones:",paragraph,277,55,2777,3054
info_cubo_egresados_v23.md,">Se excluyen los estudiantes de cursos de adaptación a grados.
>Se excluyen los estudiantes que tengan reconocidos (o adaptados o convalidados) más del 15% de los créditos
del plan de estudios.",paragraph,193,38,3056,3249
info_cubo_egresados_v23.md,=== DIMENSIONES ===,paragraph,19,3,3251,3270
info_cubo_egresados_v23.md,## DIMENSION: Acceso ##,paragraph,23,7,3272,3295
info_cubo_egresados_v23.md,"Atributos:
• Estudio previo:
Identifica la clase de estudio cursado anteriormente por los estudiantes, que les da acceso a la Universidad, de acuerdo con los requisitos establecidos por la legislación vigente.",paragraph,209,36,3297,3506
info_cubo_egresados_v23.md,">Valores posibles: Pruebas de Acceso, COU sin PAU, FP, Titulados Universitarios, Mayores de 25, Mayores de 40,
Mayores de 45.",paragraph,125,29,3508,3633
info_cubo_egresados_v23.md,">Los estudiantes procedentes de Bachillerato se incluyen en “Pruebas de Acceso”. Los estudiantes procedentes
de Ciclos Formativos de Grado Superior se incluyen en “FP”, aunque se hayan presentado a la fase específica de la EvAU.",paragraph,228,43,3635,3863
info_cubo_egresados_v23.md,">Nota: el valor “No informado” se aplica a estudiantes procedentes de adaptaciones por extinción de planes de
estudios o que no han accedido a la titulación por procedimientos de preinscripción.",paragraph,194,35,3865,4059
info_cubo_egresados_v23.md,## DIMENSION: Alumno ##,paragraph,23,7,4061,4084
info_cubo_egresados_v23.md,"Atributos:
• País Nacionalidad:
Permite clasificar los datos en función del país de nacionalidad legal de los estudiantes.",paragraph,122,21,4086,4208
info_cubo_egresados_v23.md,"• Rango de Edad:
Permite agrupar los rangos de edad de los estudiantes en función de su edad a 31 de diciembre del curso académico seleccionado.",paragraph,144,28,4210,4354
info_cubo_egresados_v23.md,">Valores posibles: 18 años o menos, 19, 20, 21, 22, 23, 24, 25, 26, 27, 28, 29, 30 a 34, 35 a 39, 40 a 44, 45 a 49,
50 a 54, 55 a 59, 60 a 64, 65 años o más.",paragraph,157,64,4356,4513
info_cubo_egresados_v23.md,"• Residencia Familiar:
Identifica el país, la comunidad autónoma, la provincia o la población de residencia familiar indicada por el estudiante en el curso académico en que se egresa.",paragraph,183,33,4515,4698
info_cubo_egresados_v23.md,"• Sexo:
Permite agrupar los estudiantes en función de su sexo.",paragraph,62,13,4700,4762
info_cubo_egresados_v23.md,## DIMENSION: CURSO ACADÉMICO ##,paragraph,32,8,4764,4796
info_cubo_egresados_v23.md,"Notas generales:
- Identifica los diferentes cursos académicos (por ejemplo 2023/24).",paragraph,85,15,4798,4883
info_cubo_egresados_v23.md,">Si se quiere consultar el número de egresados por curso académico, el curso es aquél en que el estudiante
supera los créditos necesarios para la obtención del título.",paragraph,167,31,4885,5052
info_cubo_egresados_v23.md,">En el caso de los egresados en estudios de doctorado, el curso académico de obtención del título es el de lectura
de la tesis doctoral.",paragraph,136,28,5054,5190
info_cubo_egresados_v23.md,## DIMENSION: Centro Egreso ##,paragraph,30,8,5192,5222
info_cubo_egresados_v23.md,"Notas generales:
- Permite clasificar los datos en función del centro (código y denominación) en que egresan los estudiantes.",paragraph,125,23,5224,5349
info_cubo_egresados_v23.md,"Atributos:
• Localidad:
Permite clasificar los datos en función de la localidad a la que pertenece el centro en que egresan los estudiantes.",paragraph,140,26,5351,5491
info_cubo_egresados_v23.md,"• Tipo:
Permite clasificar los datos en función del tipo de centro (facultad, escuela universitaria, centro adscrito, etc.) en que egresan los estudiantes.",paragraph,155,31,5493,5648
info_cubo_egresados_v23.md,## DIMENSION: Centro Origen ##,paragraph,30,8,5650,5680
info_cubo_egresados_v23.md,"Notas generales:
- Permite clasificar los datos en función del centro (código y denominación) en que el estudiante comenzó los estudios en los que egresa.",paragraph,154,29,5682,5836
info_cubo_egresados_v23.md,">Nota: el centro de egreso y el centro de origen coincidirá cuando el estudiante haya cursado un estudio en el
mismo centro desde el curso académico de acceso hasta el de egreso. Sin embargo no coincidirán cuando haya habido un traslado de expediente para continuar estudios o un cambio de denominación del centro.",paragraph,314,57,5838,6152
info_cubo_egresados_v23.md,"Atributos:
• Localidad:
Permite clasificar los datos en función de la localidad a la que pertenece el centro en que el estudiante comenzó los estudios en los que egresa.",paragraph,169,32,6154,6323
info_cubo_egresados_v23.md,## DIMENSION: Egreso ##,paragraph,23,7,6325,6348
info_cubo_egresados_v23.md,"Atributos:
• Abandono Inicial (S/N):
Permite distinguir los estudiantes que han interrumpido sus estudios el primer año (S: dos años consecutivos sin matrícula después del de acceso al estudio) del resto (N).",paragraph,208,42,6350,6558
info_cubo_egresados_v23.md,">Nota: se recomienda cruzar esta dimensión con la medida ""alumnos que interrumpen sus estudios"".",paragraph,96,19,6560,6656
info_cubo_egresados_v23.md,"• Créditos Matriculados:
Permite clasificar los datos en función del rango de créditos matriculados por los estudiantes egresados (cualquiera que sea su tipo de egreso: graduado, abandono, traslado).",paragraph,199,35,6658,6857
info_cubo_egresados_v23.md,"• Créditos Necesarios:
Permite clasificar los datos en función del rango de créditos necesarios que el estudiante debe superar para finalizar el estudio.",paragraph,153,25,6859,7012
info_cubo_egresados_v23.md,"• Créditos Reconocidos:
Permite clasificar los datos en función del rango de créditos reconocidos por los estudiantes egresados (cualquiera que sea su tipo de egreso: graduado, abandono, traslado).",paragraph,197,35,7014,7211
info_cubo_egresados_v23.md,"• Créditos Superados:
Permite clasificar los datos en función del rango de créditos superados por los estudiantes egresados (cualquiera que sea su tipo de egreso: graduado, abandono, traslado).",paragraph,193,35,7213,7406
info_cubo_egresados_v23.md,"• Curso más alto matriculado:
Identifica el máximo curso en que el estudiante egresado (cualquiera que sea su tipo de egreso: graduado, abandono, traslado) ha llegado a tener asignaturas matriculadas.",paragraph,200,37,7408,7608
info_cubo_egresados_v23.md,">Nota: el valor 0 se corresponde con asignaturas de Programas de Doctorado, Proyectos Fin de Carrera,
asignaturas no asociadas a curso, sino a ciclo, y asignaturas matriculadas por estudiantes de Programas de Intercambio que vienen a la UZ.",paragraph,240,45,7610,7850
info_cubo_egresados_v23.md,"• Número de años cursados:
Permite clasificar los datos en función del número de años matriculados por los estudiantes que se egresan en el curso académico seleccionado (cualquiera que sea su tipo de egreso: graduado, abandono, traslado).",paragraph,238,44,7852,8090
info_cubo_egresados_v23.md,">Nota: se contabiliza como año cursado si al menos el estudiante se matricula en una asignatura. Si en un año
académico reconoce créditos pero no matricula ninguno, no se contabiliza como año cursado.",paragraph,200,38,8092,8292
info_cubo_egresados_v23.md,"• Solicita título (S/N):
Identifica si el estudiante ha solicitado el título (S) o no (N).",paragraph,90,24,8294,8384
info_cubo_egresados_v23.md,"• Tipo de Egreso:
Clasifica a los estudiantes en función de la causa de su egreso: graduado, abandono voluntario (dos años consecutivos sin matrícula), incumplimiento de la normativa del régimen de permanencia, cambio de estudios sin simultaneidad, traslado a otra universidad.",paragraph,277,50,8386,8663
info_cubo_egresados_v23.md,## DIMENSION: Fecha de actualización ##,paragraph,39,9,8665,8704
info_cubo_egresados_v23.md,"Notas generales:
- Indica la fecha de la última recarga de datos. Habitualmente es el sábado anterior a la consulta de datos.",paragraph,125,25,8706,8831
info_cubo_egresados_v23.md,## DIMENSION: Movilidad ##,paragraph,26,7,8833,8859
info_cubo_egresados_v23.md,"Atributos:
• Internacional:
Identifica si los estudiantes egresados (cualquiera que sea su tipo de egreso: graduado, abandono, traslado) han realizado en alguno de los años en que han estado matriculados una estancia en una universidad extranjera (S) o no (N), en el marco de los acuerdos bilaterales o programas de movilidad internacionales.",paragraph,342,65,8861,9203
info_cubo_egresados_v23.md,## DIMENSION: Movilidad: Programa ##,paragraph,36,9,9205,9241
info_cubo_egresados_v23.md,"Notas generales:
- Identifica el tipo de Programa Internacional o la denominación del mismo, en caso de que los estudiantes egresados (cualquiera que sea su tipo de egreso: graduado, abandono, traslado) hayan realizado en alguno de los años en que ha estado matriculado una estancia en una universidad extranjera, en el marco de los acuerdos bilaterales o programas de movilidad internacionales, según el programa de intercambio cursado.",paragraph,437,77,9243,9680
info_cubo_egresados_v23.md,">Valores posibles Tipo Programa de Movilidad: Erasmus, Otras Dentro de la UE, Otras Fuera de la UE.
>Valores posibles Programa de Movilidad: Erasmus, Movilidad Iberoamérica, UZ/Norteamérica, Oceanía y Asia,
Movilidad UE-Suiza, etc.",paragraph,231,45,9682,9913
info_cubo_egresados_v23.md,">En el caso de no haberse realizado estancia de movilidad, se indica “No Informado”.",paragraph,84,19,9915,9999
info_cubo_egresados_v23.md,## DIMENSION: Titulación ##,paragraph,27,7,10001,10028
info_cubo_egresados_v23.md,"Atributos:
• Duración oficial:
Permite clasificar los datos en función de la duración oficial (en años) del estudio en que egresan los estudiantes.",paragraph,147,28,10030,10177
info_cubo_egresados_v23.md,">Valores posibles: 1, 2, 3, 4, 5, 6.
>Los programas de doctorado no tienen una duración establecida y figuran con el valor 0.",paragraph,125,33,10179,10304
info_cubo_egresados_v23.md,"• Estudio:
Permite identificar el estudio cursado por los estudiantes egresados. Observaciones:",paragraph,95,15,10306,10401
info_cubo_egresados_v23.md,">No es lo mismo “estudio” que “plan de estudios”.
>Bajo un mismo estudio pueden existir varios planes, bien porque se imparten en distintas localidades (ejemplos:
ADE, Enfermería, Magisterio, Medicina, etc.) o bien porque se ha modificado el plan de estudios, pero el estudio sigue siendo el mismo (ejemplos: másteres regulados por el RD 56/2005 que se renuevan en virtud del RD 1393/2007).",paragraph,390,83,10403,10793
info_cubo_egresados_v23.md,"• Múltiple titulación (S/N):
Permite identificar a los estudiantes egresados en estudios que forman parte de una múltiple titulación (S).",paragraph,137,26,10795,10932
info_cubo_egresados_v23.md,">Ejemplo: egresados en las titulaciones de Derecho o ADE cuando éstas han sido cursadas como parte de la
Programación Conjunta Derecho-ADE.",paragraph,139,24,10934,11073
info_cubo_egresados_v23.md,"• Plan de Estudios:
Permite identificar el plan de estudios (código y denominación) cursado por los estudiantes egresados.",paragraph,122,22,11075,11197
info_cubo_egresados_v23.md,"• Rama de Conocimiento:
Permite clasificar los datos en función de la Rama de Conocimiento (Artes y Humanidades, Ciencias, Ciencias Sociales y Jurídicas, Ciencias de la Salud, Ingeniería y Arquitectura) a la que pertenece el estudio en que egresan los estudiantes.",paragraph,264,49,11199,11463
info_cubo_egresados_v23.md,"• Tipo de estudio:
Permite identificar el tipo de estudio cursado por los estudiantes egresados: grado, máster, doctorado, licenciatura o equivalente, diplomatura o equivalente.",paragraph,177,31,11465,11642
info_cubo_egresados_v23.md,## DIMENSION: Traslado ##,paragraph,25,7,11644,11669
info_cubo_egresados_v23.md,"Atributos:
• Centro:
Identifica la universidad y el centro al que se trasladan los estudiantes a los que se cierra el expediente por traslado a otra universidad o centro.",paragraph,170,32,11671,11841
info_cubo_egresados_v23.md,">Nota: se recomienda cruzar esta dimensión con la medida ""alumnos que se trasladan a otra universidad"".",paragraph,103,21,11843,11946
info_cubo_egresados_v23.md,"• Estudio:
Identifica el estudio al que trasladan los estudiantes a los que se cierra el expediente por traslado a otra universidad o centro.",paragraph,141,26,11948,12089
info_cubo_egresados_v23.md,">Nota: se recomienda cruzar esta dimensión con la medida ""alumnos que se trasladan a otra universidad"".",paragraph,103,21,12091,12194
info_cubo_egresados_v23.md,"=== MEDIDAS ===

** Alumnos graduados **
Número de estudiantes que han completado todos los créditos del plan de estudios, sin tener en cuenta si han solicitado o no el título.",sentence,176,35,0,176
info_cubo_egresados_v23.md,"Notas:

>Para ser considerado graduado, un estudiante debe completar no sólo el número total de créditos de un plan
de estudios, sino los créditos mínimos de cada tipo de asignatura (básicos, obligatorios, optativos, etc.)",sentence,222,44,176,398
info_cubo_egresados_v23.md,">Aclaración referente al tipo de estudio Doctorado: no se incluyen los programas de doctorado regulados por
los RD 185/1985 y 778/1998.",sentence,135,24,399,534
info_cubo_egresados_v23.md,">Si se quiere obtener el número de alumnos graduados correspondientes al tipo de estudio Doctorado por curso
académico, el curso que se indica es aquél en que el doctorando lee su tesis doctoral.",sentence,195,36,536,731
info_cubo_egresados_v23.md,"** Alumnos que interrumpen sus estudios **
Número de estudiantes de un estudio que, sin obtener el título ni trasladarse a otra universidad, no se matriculan durante dos años consecutivos.",sentence,188,35,733,921
info_cubo_egresados_v23.md,">Nota: se identifica con los tipos de egreso “abandono voluntario” (el expediente queda abierto), “régimen de
permanencia” y “cambio de estudios sin simultaneidad”.",sentence,164,35,923,1087
info_cubo_egresados_v23.md,"** Alumnos que interrumpen sus estudios el primer año **
Es un caso particular de la medida “alumnos que interrumpen sus estudios”, siendo los dos años consecutivos de no matrícula los dos siguientes al año de acceso del estudiante al estudio.",sentence,243,47,1089,1332
info_cubo_egresados_v23.md,"** Alumnos que se trasladan a otra universidad **
Número de estudiantes de un plan de estudios a los que se les cierra el expediente por traslado a otra universidad o centro.",sentence,174,35,1334,1508
info_cubo_egresados_v23.md,"** Duración media en años de los graduados **
Media de los años que tardan los alumnos graduados en superar sus estudios.",sentence,121,25,1510,1631
info_cubo_egresados_v23.md,">Cálculo de la duración: año de la graduación – año de acceso + 1
>Criterios de cálculo:
a) Se excluyen los alumnos de cursos de adaptación a grados.",sentence,149,34,1633,1782
info_cubo_egresados_v23.md,b) Se excluyen los alumnos que tengan reconocidos (o adaptados o convalidados) más del 15% de los créditos del plan de estudios.,sentence,128,27,1784,1912
info_cubo_egresados_v23.md,c) Se excluyen los alumnos acogidos a la modalidad de tiempo parcial en alguno de los años cursados.,sentence,100,20,1913,2013
info_cubo_egresados_v23.md,"** Media de cursos matriculados **
Calcula el promedio de cursos en que se han matriculado los estudiantes egresados en un estudio, cualquiera que sea el tipo de egreso (graduado, abandono, traslado).",sentence,200,40,2014,2214
info_cubo_egresados_v23.md,">Nota: si quiere obtenerse la media de cursos matriculados por los graduados deberá seleccionarse la dimensión
""tipo de egreso"", filtrando ésta por el valor ""Graduado"".",sentence,168,33,2216,2384
info_cubo_egresados_v23.md,"** Media de créditos matriculados **
Es el promedio de la totalidad de créditos en que se han matriculado los estudiantes egresados en un estudio, cualquiera que sea el tipo de egreso (graduado, abandono, traslado).",sentence,215,43,2386,2601
info_cubo_egresados_v23.md,">Nota: si quiere obtenerse la media de créditos matriculados por los graduados deberá seleccionarse la
dimensión ""tipo de egreso"", filtrando ésta por el valor ""Graduado"".",sentence,170,33,2603,2773
info_cubo_egresados_v23.md,"** Tasa de Eficiencia (*) **
Relación porcentual entre el número total de créditos que han superado el conjunto de graduados de un determinado año académico a lo largo del estudio en el que se han titulado y el número total de créditos en que se han matriculado.",sentence,262,53,2775,3037
info_cubo_egresados_v23.md,"Observaciones:

>Se excluyen los estudiantes de cursos de adaptación a grados.",sentence,78,14,3039,3117
info_cubo_egresados_v23.md,">Se excluyen los estudiantes que tengan reconocidos (o adaptados o convalidados) más del 15% de los créditos
del plan de estudios.",sentence,130,26,3118,3248
info_cubo_egresados_v23.md,"=== DIMENSIONES ===

## DIMENSION: Acceso ##

Atributos:
• Estudio previo:
Identifica la clase de estudio cursado anteriormente por los estudiantes, que les da acceso a la Universidad, de acuerdo con los requisitos establecidos por la legislación vigente.",sentence,255,46,3249,3504
info_cubo_egresados_v23.md,">Valores posibles: Pruebas de Acceso, COU sin PAU, FP, Titulados Universitarios, Mayores de 25, Mayores de 40,
Mayores de 45.",sentence,125,29,3506,3631
info_cubo_egresados_v23.md,>Los estudiantes procedentes de Bachillerato se incluyen en “Pruebas de Acceso”.,sentence,80,15,3633,3713
info_cubo_egresados_v23.md,"Los estudiantes procedentes
de Ciclos Formativos de Grado Superior se incluyen en “FP”, aunque se hayan presentado a la fase específica de la EvAU.",sentence,147,28,3715,3862
info_cubo_egresados_v23.md,">Nota: el valor “No informado” se aplica a estudiantes procedentes de adaptaciones por extinción de planes de
estudios o que no han accedido a la titulación por procedimientos de preinscripción.",sentence,194,35,3863,4057
info_cubo_egresados_v23.md,"## DIMENSION: Alumno ##

Atributos:
• País Nacionalidad:
Permite clasificar los datos en función del país de nacionalidad legal de los estudiantes.",sentence,147,28,4059,4206
info_cubo_egresados_v23.md,"• Rango de Edad:
Permite agrupar los rangos de edad de los estudiantes en función de su edad a 31 de diciembre del curso académico seleccionado.",sentence,144,28,4208,4352
info_cubo_egresados_v23.md,">Valores posibles: 18 años o menos, 19, 20, 21, 22, 23, 24, 25, 26, 27, 28, 29, 30 a 34, 35 a 39, 40 a 44, 45 a 49,
50 a 54, 55 a 59, 60 a 64, 65 años o más.",sentence,157,64,4354,4511
info_cubo_egresados_v23.md,"• Residencia Familiar:
Identifica el país, la comunidad autónoma, la provincia o la población de residencia familiar indicada por el estudiante en el curso académico en que se egresa.",sentence,183,33,4513,4696
info_cubo_egresados_v23.md,"• Sexo:
Permite agrupar los estudiantes en función de su sexo.",sentence,62,13,4698,4760
info_cubo_egresados_v23.md,"## DIMENSION: CURSO ACADÉMICO ##

Notas generales:
- Identifica los diferentes cursos académicos (por ejemplo 2023/24).",sentence,119,23,4762,4881
info_cubo_egresados_v23.md,">Si se quiere consultar el número de egresados por curso académico, el curso es aquél en que el estudiante
supera los créditos necesarios para la obtención del título.",sentence,167,31,4883,5050
info_cubo_egresados_v23.md,">En el caso de los egresados en estudios de doctorado, el curso académico de obtención del título es el de lectura
de la tesis doctoral.",sentence,136,28,5052,5188
info_cubo_egresados_v23.md,"## DIMENSION: Centro Egreso ##

Notas generales:
- Permite clasificar los datos en función del centro (código y denominación) en que egresan los estudiantes.",sentence,157,31,5190,5347
info_cubo_egresados_v23.md,"Atributos:
• Localidad:
Permite clasificar los datos en función de la localidad a la que pertenece el centro en que egresan los estudiantes.",sentence,140,26,5349,5489
info_cubo_egresados_v23.md,"• Tipo:
Permite clasificar los datos en función del tipo de centro (facultad, escuela universitaria, centro adscrito, etc.)",sentence,123,25,5491,5614
info_cubo_egresados_v23.md,en que egresan los estudiantes.,sentence,31,6,5616,5647
info_cubo_egresados_v23.md,"## DIMENSION: Centro Origen ##

Notas generales:
- Permite clasificar los datos en función del centro (código y denominación) en que el estudiante comenzó los estudios en los que egresa.",sentence,186,37,5648,5834
info_cubo_egresados_v23.md,">Nota: el centro de egreso y el centro de origen coincidirá cuando el estudiante haya cursado un estudio en el
mismo centro desde el curso académico de acceso hasta el de egreso.",sentence,178,35,5836,6014
info_cubo_egresados_v23.md,Sin embargo no coincidirán cuando haya habido un traslado de expediente para continuar estudios o un cambio de denominación del centro.,sentence,135,22,6016,6151
info_cubo_egresados_v23.md,"Atributos:
• Localidad:
Permite clasificar los datos en función de la localidad a la que pertenece el centro en que el estudiante comenzó los estudios en los que egresa.",sentence,169,32,6152,6321
info_cubo_egresados_v23.md,"## DIMENSION: Egreso ##

Atributos:
• Abandono Inicial (S/N):
Permite distinguir los estudiantes que han interrumpido sus estudios el primer año (S: dos años consecutivos sin matrícula después del de acceso al estudio) del resto (N).",sentence,233,49,6323,6556
info_cubo_egresados_v23.md,">Nota: se recomienda cruzar esta dimensión con la medida ""alumnos que interrumpen sus estudios"".",sentence,96,19,6558,6654
info_cubo_egresados_v23.md,"• Créditos Matriculados:
Permite clasificar los datos en función del rango de créditos matriculados por los estudiantes egresados (cualquiera que sea su tipo de egreso: graduado, abandono, traslado).",sentence,199,35,6656,6855
info_cubo_egresados_v23.md,"• Créditos Necesarios:
Permite clasificar los datos en función del rango de créditos necesarios que el estudiante debe superar para finalizar el estudio.",sentence,153,25,6857,7010
info_cubo_egresados_v23.md,"• Créditos Reconocidos:
Permite clasificar los datos en función del rango de créditos reconocidos por los estudiantes egresados (cualquiera que sea su tipo de egreso: graduado, abandono, traslado).",sentence,197,35,7012,7209
info_cubo_egresados_v23.md,"• Créditos Superados:
Permite clasificar los datos en función del rango de créditos superados por los estudiantes egresados (cualquiera que sea su tipo de egreso: graduado, abandono, traslado).",sentence,193,35,7211,7404
info_cubo_egresados_v23.md,"• Curso más alto matriculado:
Identifica el máximo curso en que el estudiante egresado (cualquiera que sea su tipo de egreso: graduado, abandono, traslado) ha llegado a tener asignaturas matriculadas.",sentence,200,37,7406,7606
info_cubo_egresados_v23.md,">Nota: el valor 0 se corresponde con asignaturas de Programas de Doctorado, Proyectos Fin de Carrera,
asignaturas no asociadas a curso, sino a ciclo, y asignaturas matriculadas por estudiantes de Programas de Intercambio que vienen a la UZ.",sentence,240,45,7608,7848
info_cubo_egresados_v23.md,"• Número de años cursados:
Permite clasificar los datos en función del número de años matriculados por los estudiantes que se egresan en el curso académico seleccionado (cualquiera que sea su tipo de egreso: graduado, abandono, traslado).",sentence,238,44,7850,8088
info_cubo_egresados_v23.md,>Nota: se contabiliza como año cursado si al menos el estudiante se matricula en una asignatura.,sentence,96,19,8090,8186
info_cubo_egresados_v23.md,"Si en un año
académico reconoce créditos pero no matricula ninguno, no se contabiliza como año cursado.",sentence,103,19,8188,8291
info_cubo_egresados_v23.md,"• Solicita título (S/N):
Identifica si el estudiante ha solicitado el título (S) o no (N).",sentence,90,24,8292,8382
info_cubo_egresados_v23.md,"• Tipo de Egreso:
Clasifica a los estudiantes en función de la causa de su egreso: graduado, abandono voluntario (dos años consecutivos sin matrícula), incumplimiento de la normativa del régimen de permanencia, cambio de estudios sin simultaneidad, traslado a otra universidad.",sentence,277,50,8384,8661
info_cubo_egresados_v23.md,"## DIMENSION: Fecha de actualización ##

Notas generales:
- Indica la fecha de la última recarga de datos.",sentence,106,23,8663,8769
info_cubo_egresados_v23.md,Habitualmente es el sábado anterior a la consulta de datos.,sentence,59,11,8771,8830
info_cubo_egresados_v23.md,"## DIMENSION: Movilidad ##

Atributos:
• Internacional:
Identifica si los estudiantes egresados (cualquiera que sea su tipo de egreso: graduado, abandono, traslado) han realizado en alguno de los años en que han estado matriculados una estancia en una universidad extranjera (S) o no (N), en el marco de los acuerdos bilaterales o programas de movilidad internacionales.",sentence,370,72,8831,9201
info_cubo_egresados_v23.md,"## DIMENSION: Movilidad: Programa ##

Notas generales:
- Identifica el tipo de Programa Internacional o la denominación del mismo, en caso de que los estudiantes egresados (cualquiera que sea su tipo de egreso: graduado, abandono, traslado) hayan realizado en alguno de los años en que ha estado matriculado una estancia en una universidad extranjera, en el marco de los acuerdos bilaterales o programas de movilidad internacionales, según el programa de intercambio cursado.",sentence,475,86,9203,9678
info_cubo_egresados_v23.md,">Valores posibles Tipo Programa de Movilidad: Erasmus, Otras Dentro de la UE, Otras Fuera de la UE.",sentence,99,22,9680,9779
info_cubo_egresados_v23.md,">Valores posibles Programa de Movilidad: Erasmus, Movilidad Iberoamérica, UZ/Norteamérica, Oceanía y Asia,
Movilidad UE-Suiza, etc.",sentence,131,23,9781,9912
info_cubo_egresados_v23.md,">En el caso de no haberse realizado estancia de movilidad, se indica “No Informado”.",sentence,84,19,9913,9997
info_cubo_egresados_v23.md,"## DIMENSION: Titulación ##

Atributos:
• Duración oficial:
Permite clasificar los datos en función de la duración oficial (en años) del estudio en que egresan los estudiantes.",sentence,176,35,9999,10175
info_cubo_egresados_v23.md,">Valores posibles: 1, 2, 3, 4, 5, 6.",sentence,36,16,10177,10213
info_cubo_egresados_v23.md,>Los programas de doctorado no tienen una duración establecida y figuran con el valor 0.,sentence,88,17,10215,10303
info_cubo_egresados_v23.md,"• Estudio:
Permite identificar el estudio cursado por los estudiantes egresados.",sentence,80,13,10304,10384
info_cubo_egresados_v23.md,"Observaciones:

>No es lo mismo “estudio” que “plan de estudios”.",sentence,65,17,10386,10451
info_cubo_egresados_v23.md,">Bajo un mismo estudio pueden existir varios planes, bien porque se imparten en distintas localidades (ejemplos:
ADE, Enfermería, Magisterio, Medicina, etc.)",sentence,157,31,10452,10609
info_cubo_egresados_v23.md,"o bien porque se ha modificado el plan de estudios, pero el estudio sigue siendo el mismo (ejemplos: másteres regulados por el RD 56/2005 que se renuevan en virtud del RD 1393/2007).",sentence,182,37,10610,10792
info_cubo_egresados_v23.md,"• Múltiple titulación (S/N):
Permite identificar a los estudiantes egresados en estudios que forman parte de una múltiple titulación (S).",sentence,137,26,10793,10930
info_cubo_egresados_v23.md,">Ejemplo: egresados en las titulaciones de Derecho o ADE cuando éstas han sido cursadas como parte de la
Programación Conjunta Derecho-ADE.",sentence,139,24,10932,11071
info_cubo_egresados_v23.md,"• Plan de Estudios:
Permite identificar el plan de estudios (código y denominación) cursado por los estudiantes egresados.",sentence,122,22,11073,11195
info_cubo_egresados_v23.md,"• Rama de Conocimiento:
Permite clasificar los datos en función de la Rama de Conocimiento (Artes y Humanidades, Ciencias, Ciencias Sociales y Jurídicas, Ciencias de la Salud, Ingeniería y Arquitectura) a la que pertenece el estudio en que egresan los estudiantes.",sentence,264,49,11197,11461
info_cubo_egresados_v23.md,"• Tipo de estudio:
Permite identificar el tipo de estudio cursado por los estudiantes egresados: grado, máster, doctorado, licenciatura o equivalente, diplomatura o equivalente.",sentence,177,31,11463,11640
info_cubo_egresados_v23.md,"## DIMENSION: Traslado ##

Atributos:
• Centro:
Identifica la universidad y el centro al que se trasladan los estudiantes a los que se cierra el expediente por traslado a otra universidad o centro.",sentence,197,39,11642,11839
info_cubo_egresados_v23.md,">Nota: se recomienda cruzar esta dimensión con la medida ""alumnos que se trasladan a otra universidad"".",sentence,103,21,11841,11944
info_cubo_egresados_v23.md,"• Estudio:
Identifica el estudio al que trasladan los estudiantes a los que se cierra el expediente por traslado a otra universidad o centro.",sentence,141,26,11946,12087
info_cubo_egresados_v23.md,">Nota: se recomienda cruzar esta dimensión con la medida ""alumnos que se trasladan a otra universidad"".",sentence,103,21,12089,12192
info_cubo_estudiantesIN_v12.md,"=== MEDIDAS ===

** Total de Estudiantes IN **
Número total de estudiantes de otras universidades que, en virtud de programas de intercambio de entrada la UZ, se matriculan en los planes de movilidad 107 (Movilidad para 1º y 2º ciclo y grado) ó 266 (Movilidad pa máster) para cursar asignaturas de uno o varios planes de estudios. Notas:

>El número de estudiantes IN puede variar en función de las dimensiones con las que se combine.
>Al combinar esta medida con la dimensión “plan de estudio” se contabilizan los estudiantes tantas veces
como planes de estudio distintos a los que pertenezcan las asignaturas en que se matriculen. Esta circunstancia puede darse también con las dimensiones “estudio”, “rama de conocimiento”, “tipo de estudio “centro de asignatura”. En consecuencia, en todos estos casos, se ha de tener en cuenta que no se totalizan estudiantes únicos.

** Duración media de la estancia (meses) **
Media aritmética de los meses que dura la estancia de los estudiantes de otras universidades que, en virtud d programas de intercambio de entrada a Unizar, se matriculan en los planes de movilidad 107 (Movilidad para 1º y 2º ciclo y grado) ó 266 (Movilidad para máster).

** Tasa de rendimiento **
Relación porcentual entre el número total de créditos superados y el número total de créditos matriculados p los estudiantes durante la estancia.",section,1361,268,0,1361
info_cubo_estudiantesIN_v12.md,=== DIMENSIONES ===,section,20,3,1362,1382
info_cubo_estudiantesIN_v12.md,"## DIMENSION: Alumno ##

Atributos:
• Nacionalidad:
Permite clasificar los datos en función de la nacionalidad legal de los estudiantes.

• Rango de edad:
Permite agrupar los rangos de edad de los estudiantes en función de su edad a fecha 31 de diciembre del cur académico en que están matriculados.

>Valores posibles: 18 años o menos, 19, 20, 21, 22, 23, 24, 25, 26, 27, 28, 29, 30 a 34, 35 a 39, 40 a 44, 45 a 4
50 a 54, 55 a 59, 60 a 64, 65 años o más.

• Sexo:
Permite agrupar los estudiantes en función de su sexo.",section,521,134,1383,1904
info_cubo_estudiantesIN_v12.md,"## DIMENSION: CURSO ACADÉMICO ##

Notas generales:
- Clasifica los datos en función del curso académico en que el estudiante realiza la estancia.

>Nota: El primer curso académico del que constan datos es el 2008/09.",section,217,43,1905,2122
info_cubo_estudiantesIN_v12.md,"## DIMENSION: Centro de Acogida ##

Notas generales:
- Permite clasificar los datos en función del centro al que el estudiante es asignado administrativamente (denominación), de la localidad y campus en el que se ubica y del tipo de centro (facultad, escuela universitar centro adscrito, etc.).

>Cada estudiante sólo puede tener un centro administrativo de acogida.
>Cada estudiante puede matricularse en asignaturas de planes de estudios que se imparten en el centro de
acogida o en otros centros distintos del de acogida.",section,525,98,2123,2648
info_cubo_estudiantesIN_v12.md,"## DIMENSION: Centro de Asignatura ##

Notas generales:
- Permite clasificar los datos en función del centro en el que se imparte el plan de estudios al que pertenecen l asignaturas matriculadas por los estudiantes.

>Cada estudiante puede tener más de un centro de asignatura (en función de los planes de estudios a los que
pertenezcan las asignaturas matriculadas), que puede o no coincidir con el centro administrativo de acogida.

>Cada estudiante puede matricularse en asignaturas de planes de estudios que se imparten en el centro de
acogida o en otros centros distintos del de acogida. Por tanto si en una consulta se incorpora la medida “Estudiantes IN” y la dimensión “Centro de asignatura”, un mismo estudiante se contará tantas veces como centros distintos haya de impartición de planes de estudios en los que haya matriculado asignaturas.",section,851,155,2649,3500
info_cubo_estudiantesIN_v12.md,"## DIMENSION: Expediente ##

Atributos:
• Créditos matriculados:
Permite clasificar los datos en función del número (o del rango) de créditos matriculados por los estudiantes durante su estancia.

• Créditos superados:
Permite clasificar los datos en función del número (o del rango) de créditos superados por los estudiantes durante su estancia.",section,347,63,3501,3848
info_cubo_estudiantesIN_v12.md,"## DIMENSION: Fecha de actualización ##

Notas generales:
- Indica la fecha de la última recarga de datos. Habitualmente se realiza el domingo anterior a la fecha de consulta de datos.",section,185,37,3849,4034
info_cubo_estudiantesIN_v12.md,"## DIMENSION: Movilidad ##

Atributos:
• País de la Universidad de Origen:
Permite clasificar los datos en función del país al que pertenece la universidad de origen de los estudiantes.

• Programa de Movilidad:
Permite clasificar los datos en función del programa de movilidad en virtud del cual se realiza la estancia. Esta dimensión tiene tres atributos: • “Programa Internacional (S/N)”: distingue los programas de movilidad internacionales (S) de los que lo son (N), como el SICUE. • “Tipo de programa de movilidad”. Valores posibles: Erasmus, SICUE-SÉNECA, Movilidad en másteres (AGE), Otras Dentro de la UE y Otras Fuera de la UE. • “Programa de movilidad”: indica el programa concreto en virtud del cual el alumno realiza la estancia tiene entre otros los siguientes valores: Erasmus, SICUE, Movilidad Transfronteriza, Movilidad Iberoamérica, UZ/Norteamérica, Oceanía y Asia, Doble titulación Máster FEGP, Movilidad UE-Suiza, UZ/Brasil, Americampus, Bancaja, etc.

• Universidad de Origen:
Permite clasificar los datos en función de la universidad de la procedencia de los estudiantes.

• Universidad de Origen UNITA S/N:
Permite clasificar los datos en función de si la universidad de la procedencia de los estudiantes pertenece a la alianza de universidades europeas UNITA (S) o no (N).

>El primer curso académico en que están registradas universidades UNITA es 2020/21.",section,1382,266,4035,5417
info_cubo_estudiantesIN_v12.md,"## DIMENSION: Titulación ##

Atributos:
• Estudio:
Permite clasificar los datos en función del estudio al que pertenece la asignatura matriculada por el estudiant de intercambio. Es adecuado si queremos agrupar los datos de los estudios que se imparten en varias localidades (ejemplo: ADE, Enfermería, Magisterio, Medicina, etc.). Debido a que los estudiantes pueden matricularse en asignaturas de varios planes, puede que no todos los Estudios pertenezcan al centro al que el estudiante está acogido administrativamente.

• Plan de Estudios:
Permite clasificar los datos en función del plan de estudios al que pertenece la asignatura matriculada por el estudiante de intercambio (código y denominación). Debido a que los estudiantes pueden matricularse en asignaturas de varios planes, puede que no todos los planes pertenezcan al centro al que el estudiante está asignado.

• Rama de Conocimiento:
Permite clasificar los datos en función de la Rama de Conocimiento (Artes y Humanidades, Ciencias, Ciencias Sociales y Jurídicas, Ciencias de la Salud, Ingeniería y Arquitectura) a la que pertenece el Estudio al que corresponde la asignatura matriculada por el estudiante de intercambio. Debido a que los estudiantes pueden matricularse en asignaturas de varios planes, puede que no todas las ramas de conocimiento pertenezcan al centro al que el estudiante está asignado.

• Tipo de estudio:
Permite identificar el tipo de estudio al que corresponden las asignaturas matriculadas por los estudiantes de intercambio: grado, máster. Con anterioridad al curso 2016/17 se muestran también licenciatura o equivalente, diplomatura o equivalent El valor “Movilidad de entrada” se muestra si los estudiantes no se encuentran matriculados en asignaturas pertenecientes a planes de estudios de grado o máster. Ejemplo: prácticas de intercambio.",section,1837,315,5418,7255
info_cubo_estudiantesIN_v12.md,=== MEDIDAS ===,paragraph,15,3,0,15
info_cubo_estudiantesIN_v12.md,"** Total de Estudiantes IN **
Número total de estudiantes de otras universidades que, en virtud de programas de intercambio de entrada la UZ, se matriculan en los planes de movilidad 107 (Movilidad para 1º y 2º ciclo y grado) ó 266 (Movilidad pa máster) para cursar asignaturas de uno o varios planes de estudios. Notas:",paragraph,320,66,17,337
info_cubo_estudiantesIN_v12.md,">El número de estudiantes IN puede variar en función de las dimensiones con las que se combine.
>Al combinar esta medida con la dimensión “plan de estudio” se contabilizan los estudiantes tantas veces
como planes de estudio distintos a los que pertenezcan las asignaturas en que se matriculen. Esta circunstancia puede darse también con las dimensiones “estudio”, “rama de conocimiento”, “tipo de estudio “centro de asignatura”. En consecuencia, en todos estos casos, se ha de tener en cuenta que no se totalizan estudiantes únicos.",paragraph,532,103,339,871
info_cubo_estudiantesIN_v12.md,"** Duración media de la estancia (meses) **
Media aritmética de los meses que dura la estancia de los estudiantes de otras universidades que, en virtud d programas de intercambio de entrada a Unizar, se matriculan en los planes de movilidad 107 (Movilidad para 1º y 2º ciclo y grado) ó 266 (Movilidad para máster).",paragraph,314,66,873,1187
info_cubo_estudiantesIN_v12.md,"** Tasa de rendimiento **
Relación porcentual entre el número total de créditos superados y el número total de créditos matriculados p los estudiantes durante la estancia.",paragraph,171,30,1189,1360
info_cubo_estudiantesIN_v12.md,=== DIMENSIONES ===,paragraph,19,3,1362,1381
info_cubo_estudiantesIN_v12.md,## DIMENSION: Alumno ##,paragraph,23,7,1383,1406
info_cubo_estudiantesIN_v12.md,"Atributos:
• Nacionalidad:
Permite clasificar los datos en función de la nacionalidad legal de los estudiantes.",paragraph,111,19,1408,1519
info_cubo_estudiantesIN_v12.md,"• Rango de edad:
Permite agrupar los rangos de edad de los estudiantes en función de su edad a fecha 31 de diciembre del cur académico en que están matriculados.",paragraph,161,32,1521,1682
info_cubo_estudiantesIN_v12.md,">Valores posibles: 18 años o menos, 19, 20, 21, 22, 23, 24, 25, 26, 27, 28, 29, 30 a 34, 35 a 39, 40 a 44, 45 a 4
50 a 54, 55 a 59, 60 a 64, 65 años o más.",paragraph,155,63,1684,1839
info_cubo_estudiantesIN_v12.md,"• Sexo:
Permite agrupar los estudiantes en función de su sexo.",paragraph,62,13,1841,1903
info_cubo_estudiantesIN_v12.md,## DIMENSION: CURSO ACADÉMICO ##,paragraph,32,8,1905,1937
info_cubo_estudiantesIN_v12.md,"Notas generales:
- Clasifica los datos en función del curso académico en que el estudiante realiza la estancia.",paragraph,111,20,1939,2050
info_cubo_estudiantesIN_v12.md,>Nota: El primer curso académico del que constan datos es el 2008/09.,paragraph,69,15,2052,2121
info_cubo_estudiantesIN_v12.md,## DIMENSION: Centro de Acogida ##,paragraph,34,9,2123,2157
info_cubo_estudiantesIN_v12.md,"Notas generales:
- Permite clasificar los datos en función del centro al que el estudiante es asignado administrativamente (denominación), de la localidad y campus en el que se ubica y del tipo de centro (facultad, escuela universitar centro adscrito, etc.).",paragraph,258,50,2159,2417
info_cubo_estudiantesIN_v12.md,">Cada estudiante sólo puede tener un centro administrativo de acogida.
>Cada estudiante puede matricularse en asignaturas de planes de estudios que se imparten en el centro de
acogida o en otros centros distintos del de acogida.",paragraph,228,40,2419,2647
info_cubo_estudiantesIN_v12.md,## DIMENSION: Centro de Asignatura ##,paragraph,37,9,2649,2686
info_cubo_estudiantesIN_v12.md,"Notas generales:
- Permite clasificar los datos en función del centro en el que se imparte el plan de estudios al que pertenecen l asignaturas matriculadas por los estudiantes.",paragraph,176,31,2688,2864
info_cubo_estudiantesIN_v12.md,">Cada estudiante puede tener más de un centro de asignatura (en función de los planes de estudios a los que
pertenezcan las asignaturas matriculadas), que puede o no coincidir con el centro administrativo de acogida.",paragraph,216,40,2866,3082
info_cubo_estudiantesIN_v12.md,">Cada estudiante puede matricularse en asignaturas de planes de estudios que se imparten en el centro de
acogida o en otros centros distintos del de acogida. Por tanto si en una consulta se incorpora la medida “Estudiantes IN” y la dimensión “Centro de asignatura”, un mismo estudiante se contará tantas veces como centros distintos haya de impartición de planes de estudios en los que haya matriculado asignaturas.",paragraph,415,75,3084,3499
info_cubo_estudiantesIN_v12.md,## DIMENSION: Expediente ##,paragraph,27,7,3501,3528
info_cubo_estudiantesIN_v12.md,"Atributos:
• Créditos matriculados:
Permite clasificar los datos en función del número (o del rango) de créditos matriculados por los estudiantes durante su estancia.",paragraph,166,29,3530,3696
info_cubo_estudiantesIN_v12.md,"• Créditos superados:
Permite clasificar los datos en función del número (o del rango) de créditos superados por los estudiantes durante su estancia.",paragraph,149,27,3698,3847
info_cubo_estudiantesIN_v12.md,## DIMENSION: Fecha de actualización ##,paragraph,39,9,3849,3888
info_cubo_estudiantesIN_v12.md,"Notas generales:
- Indica la fecha de la última recarga de datos. Habitualmente se realiza el domingo anterior a la fecha de consulta de datos.",paragraph,143,28,3890,4033
info_cubo_estudiantesIN_v12.md,## DIMENSION: Movilidad ##,paragraph,26,7,4035,4061
info_cubo_estudiantesIN_v12.md,"Atributos:
• País de la Universidad de Origen:
Permite clasificar los datos en función del país al que pertenece la universidad de origen de los estudiantes.",paragraph,157,29,4063,4220
info_cubo_estudiantesIN_v12.md,"• Programa de Movilidad:
Permite clasificar los datos en función del programa de movilidad en virtud del cual se realiza la estancia. Esta dimensión tiene tres atributos: • “Programa Internacional (S/N)”: distingue los programas de movilidad internacionales (S) de los que lo son (N), como el SICUE. • “Tipo de programa de movilidad”. Valores posibles: Erasmus, SICUE-SÉNECA, Movilidad en másteres (AGE), Otras Dentro de la UE y Otras Fuera de la UE. • “Programa de movilidad”: indica el programa concreto en virtud del cual el alumno realiza la estancia tiene entre otros los siguientes valores: Erasmus, SICUE, Movilidad Transfronteriza, Movilidad Iberoamérica, UZ/Norteamérica, Oceanía y Asia, Doble titulación Máster FEGP, Movilidad UE-Suiza, UZ/Brasil, Americampus, Bancaja, etc.",paragraph,784,155,4222,5006
info_cubo_estudiantesIN_v12.md,"• Universidad de Origen:
Permite clasificar los datos en función de la universidad de la procedencia de los estudiantes.",paragraph,120,21,5008,5128
info_cubo_estudiantesIN_v12.md,"• Universidad de Origen UNITA S/N:
Permite clasificar los datos en función de si la universidad de la procedencia de los estudiantes pertenece a la alianza de universidades europeas UNITA (S) o no (N).",paragraph,201,40,5130,5331
info_cubo_estudiantesIN_v12.md,>El primer curso académico en que están registradas universidades UNITA es 2020/21.,paragraph,83,14,5333,5416
info_cubo_estudiantesIN_v12.md,## DIMENSION: Titulación ##,paragraph,27,7,5418,5445
info_cubo_estudiantesIN_v12.md,"Atributos:
• Estudio:
Permite clasificar los datos en función del estudio al que pertenece la asignatura matriculada por el estudiant de intercambio. Es adecuado si queremos agrupar los datos de los estudios que se imparten en varias localidades (ejemplo: ADE, Enfermería, Magisterio, Medicina, etc.). Debido a que los estudiantes pueden matricularse en asignaturas de varios planes, puede que no todos los Estudios pertenezcan al centro al que el estudiante está acogido administrativamente.",paragraph,492,85,5447,5939
info_cubo_estudiantesIN_v12.md,"• Plan de Estudios:
Permite clasificar los datos en función del plan de estudios al que pertenece la asignatura matriculada por el estudiante de intercambio (código y denominación). Debido a que los estudiantes pueden matricularse en asignaturas de varios planes, puede que no todos los planes pertenezcan al centro al que el estudiante está asignado.",paragraph,351,61,5941,6292
info_cubo_estudiantesIN_v12.md,"• Rama de Conocimiento:
Permite clasificar los datos en función de la Rama de Conocimiento (Artes y Humanidades, Ciencias, Ciencias Sociales y Jurídicas, Ciencias de la Salud, Ingeniería y Arquitectura) a la que pertenece el Estudio al que corresponde la asignatura matriculada por el estudiante de intercambio. Debido a que los estudiantes pueden matricularse en asignaturas de varios planes, puede que no todas las ramas de conocimiento pertenezcan al centro al que el estudiante está asignado.",paragraph,496,86,6294,6790
info_cubo_estudiantesIN_v12.md,"• Tipo de estudio:
Permite identificar el tipo de estudio al que corresponden las asignaturas matriculadas por los estudiantes de intercambio: grado, máster. Con anterioridad al curso 2016/17 se muestran también licenciatura o equivalente, diplomatura o equivalent El valor “Movilidad de entrada” se muestra si los estudiantes no se encuentran matriculados en asignaturas pertenecientes a planes de estudios de grado o máster. Ejemplo: prácticas de intercambio.",paragraph,461,76,6792,7253
info_cubo_estudiantesIN_v12.md,"=== MEDIDAS ===

** Total de Estudiantes IN **
Número total de estudiantes de otras universidades que, en virtud de programas de intercambio de entrada la UZ, se matriculan en los planes de movilidad 107 (Movilidad para 1º y 2º ciclo y grado) ó 266 (Movilidad pa máster) para cursar asignaturas de uno o varios planes de estudios.",sentence,330,67,0,330
info_cubo_estudiantesIN_v12.md,"Notas:

>El número de estudiantes IN puede variar en función de las dimensiones con las que se combine.",sentence,103,21,330,433
info_cubo_estudiantesIN_v12.md,">Al combinar esta medida con la dimensión “plan de estudio” se contabilizan los estudiantes tantas veces
como planes de estudio distintos a los que pertenezcan las asignaturas en que se matriculen.",sentence,197,35,434,631
info_cubo_estudiantesIN_v12.md,"Esta circunstancia puede darse también con las dimensiones “estudio”, “rama de conocimiento”, “tipo de estudio “centro de asignatura”.",sentence,134,28,632,766
info_cubo_estudiantesIN_v12.md,"En consecuencia, en todos estos casos, se ha de tener en cuenta que no se totalizan estudiantes únicos.",sentence,103,21,767,870
info_cubo_estudiantesIN_v12.md,"** Duración media de la estancia (meses) **
Media aritmética de los meses que dura la estancia de los estudiantes de otras universidades que, en virtud d programas de intercambio de entrada a Unizar, se matriculan en los planes de movilidad 107 (Movilidad para 1º y 2º ciclo y grado) ó 266 (Movilidad para máster).",sentence,314,66,871,1185
info_cubo_estudiantesIN_v12.md,"** Tasa de rendimiento **
Relación porcentual entre el número total de créditos superados y el número total de créditos matriculados p los estudiantes durante la estancia.",sentence,171,30,1187,1358
info_cubo_estudiantesIN_v12.md,"=== DIMENSIONES ===

## DIMENSION: Alumno ##

Atributos:
• Nacionalidad:
Permite clasificar los datos en función de la nacionalidad legal de los estudiantes.",sentence,157,29,1360,1517
info_cubo_estudiantesIN_v12.md,"• Rango de edad:
Permite agrupar los rangos de edad de los estudiantes en función de su edad a fecha 31 de diciembre del cur académico en que están matriculados.",sentence,161,32,1519,1680
info_cubo_estudiantesIN_v12.md,">Valores posibles: 18 años o menos, 19, 20, 21, 22, 23, 24, 25, 26, 27, 28, 29, 30 a 34, 35 a 39, 40 a 44, 45 a 4
50 a 54, 55 a 59, 60 a 64, 65 años o más.",sentence,155,63,1682,1837
info_cubo_estudiantesIN_v12.md,"• Sexo:
Permite agrupar los estudiantes en función de su sexo.",sentence,62,13,1839,1901
info_cubo_estudiantesIN_v12.md,"## DIMENSION: CURSO ACADÉMICO ##

Notas generales:
- Clasifica los datos en función del curso académico en que el estudiante realiza la estancia.",sentence,145,28,1903,2048
info_cubo_estudiantesIN_v12.md,>Nota: El primer curso académico del que constan datos es el 2008/09.,sentence,69,15,2050,2119
info_cubo_estudiantesIN_v12.md,"## DIMENSION: Centro de Acogida ##

Notas generales:
- Permite clasificar los datos en función del centro al que el estudiante es asignado administrativamente (denominación), de la localidad y campus en el que se ubica y del tipo de centro (facultad, escuela universitar centro adscrito, etc.).",sentence,294,59,2121,2415
info_cubo_estudiantesIN_v12.md,>Cada estudiante sólo puede tener un centro administrativo de acogida.,sentence,70,12,2417,2487
info_cubo_estudiantesIN_v12.md,">Cada estudiante puede matricularse en asignaturas de planes de estudios que se imparten en el centro de
acogida o en otros centros distintos del de acogida.",sentence,157,28,2489,2646
info_cubo_estudiantesIN_v12.md,"## DIMENSION: Centro de Asignatura ##

Notas generales:
- Permite clasificar los datos en función del centro en el que se imparte el plan de estudios al que pertenecen l asignaturas matriculadas por los estudiantes.",sentence,215,40,2647,2862
info_cubo_estudiantesIN_v12.md,">Cada estudiante puede tener más de un centro de asignatura (en función de los planes de estudios a los que
pertenezcan las asignaturas matriculadas), que puede o no coincidir con el centro administrativo de acogida.",sentence,216,40,2864,3080
info_cubo_estudiantesIN_v12.md,">Cada estudiante puede matricularse en asignaturas de planes de estudios que se imparten en el centro de
acogida o en otros centros distintos del de acogida.",sentence,157,28,3082,3239
info_cubo_estudiantesIN_v12.md,"Por tanto si en una consulta se incorpora la medida “Estudiantes IN” y la dimensión “Centro de asignatura”, un mismo estudiante se contará tantas veces como centros distintos haya de impartición de planes de estudios en los que haya matriculado asignaturas.",sentence,257,47,3241,3498
info_cubo_estudiantesIN_v12.md,"## DIMENSION: Expediente ##

Atributos:
• Créditos matriculados:
Permite clasificar los datos en función del número (o del rango) de créditos matriculados por los estudiantes durante su estancia.",sentence,195,36,3499,3694
info_cubo_estudiantesIN_v12.md,"• Créditos superados:
Permite clasificar los datos en función del número (o del rango) de créditos superados por los estudiantes durante su estancia.",sentence,149,27,3696,3845
info_cubo_estudiantesIN_v12.md,"## DIMENSION: Fecha de actualización ##

Notas generales:
- Indica la fecha de la última recarga de datos.",sentence,106,23,3847,3953
info_cubo_estudiantesIN_v12.md,Habitualmente se realiza el domingo anterior a la fecha de consulta de datos.,sentence,77,14,3955,4032
info_cubo_estudiantesIN_v12.md,"## DIMENSION: Movilidad ##

Atributos:
• País de la Universidad de Origen:
Permite clasificar los datos en función del país al que pertenece la universidad de origen de los estudiantes.",sentence,185,36,4033,4218
info_cubo_estudiantesIN_v12.md,"• Programa de Movilidad:
Permite clasificar los datos en función del programa de movilidad en virtud del cual se realiza la estancia.",sentence,133,24,4220,4353
info_cubo_estudiantesIN_v12.md,"Esta dimensión tiene tres atributos: • “Programa Internacional (S/N)”: distingue los programas de movilidad internacionales (S) de los que lo son (N), como el SICUE.",sentence,165,37,4355,4520
info_cubo_estudiantesIN_v12.md,• “Tipo de programa de movilidad”.,sentence,34,9,4521,4555
info_cubo_estudiantesIN_v12.md,"Valores posibles: Erasmus, SICUE-SÉNECA, Movilidad en másteres (AGE), Otras Dentro de la UE y Otras Fuera de la UE.",sentence,115,26,4556,4671
info_cubo_estudiantesIN_v12.md,"• “Programa de movilidad”: indica el programa concreto en virtud del cual el alumno realiza la estancia tiene entre otros los siguientes valores: Erasmus, SICUE, Movilidad Transfronteriza, Movilidad Iberoamérica, UZ/Norteamérica, Oceanía y Asia, Doble titulación Máster FEGP, Movilidad UE-Suiza, UZ/Brasil, Americampus, Bancaja, etc.",sentence,333,59,4672,5005
info_cubo_estudiantesIN_v12.md,"• Universidad de Origen:
Permite clasificar los datos en función de la universidad de la procedencia de los estudiantes.",sentence,120,21,5006,5126
info_cubo_estudiantesIN_v12.md,"• Universidad de Origen UNITA S/N:
Permite clasificar los datos en función de si la universidad de la procedencia de los estudiantes pertenece a la alianza de universidades europeas UNITA (S) o no (N).",sentence,201,40,5128,5329
info_cubo_estudiantesIN_v12.md,>El primer curso académico en que están registradas universidades UNITA es 2020/21.,sentence,83,14,5331,5414
info_cubo_estudiantesIN_v12.md,"## DIMENSION: Titulación ##

Atributos:
• Estudio:
Permite clasificar los datos en función del estudio al que pertenece la asignatura matriculada por el estudiant de intercambio.",sentence,178,32,5416,5594
info_cubo_estudiantesIN_v12.md,"Es adecuado si queremos agrupar los datos de los estudios que se imparten en varias localidades (ejemplo: ADE, Enfermería, Magisterio, Medicina, etc.).",sentence,151,31,5596,5747
info_cubo_estudiantesIN_v12.md,"Debido a que los estudiantes pueden matricularse en asignaturas de varios planes, puede que no todos los Estudios pertenezcan al centro al que el estudiante está acogido administrativamente.",sentence,190,30,5748,5938
info_cubo_estudiantesIN_v12.md,"• Plan de Estudios:
Permite clasificar los datos en función del plan de estudios al que pertenece la asignatura matriculada por el estudiante de intercambio (código y denominación).",sentence,181,32,5939,6120
info_cubo_estudiantesIN_v12.md,"Debido a que los estudiantes pueden matricularse en asignaturas de varios planes, puede que no todos los planes pertenezcan al centro al que el estudiante está asignado.",sentence,169,29,6122,6291
info_cubo_estudiantesIN_v12.md,"• Rama de Conocimiento:
Permite clasificar los datos en función de la Rama de Conocimiento (Artes y Humanidades, Ciencias, Ciencias Sociales y Jurídicas, Ciencias de la Salud, Ingeniería y Arquitectura) a la que pertenece el Estudio al que corresponde la asignatura matriculada por el estudiante de intercambio.",sentence,311,55,6292,6603
info_cubo_estudiantesIN_v12.md,"Debido a que los estudiantes pueden matricularse en asignaturas de varios planes, puede que no todas las ramas de conocimiento pertenezcan al centro al que el estudiante está asignado.",sentence,184,31,6605,6789
info_cubo_estudiantesIN_v12.md,"• Tipo de estudio:
Permite identificar el tipo de estudio al que corresponden las asignaturas matriculadas por los estudiantes de intercambio: grado, máster.",sentence,157,27,6790,6947
info_cubo_estudiantesIN_v12.md,"Con anterioridad al curso 2016/17 se muestran también licenciatura o equivalente, diplomatura o equivalent El valor “Movilidad de entrada” se muestra si los estudiantes no se encuentran matriculados en asignaturas pertenecientes a planes de estudios de grado o máster.",sentence,268,43,6949,7217
info_cubo_estudiantesIN_v12.md,Ejemplo: prácticas de intercambio.,sentence,34,6,7218,7252
info_cubo_estudiantesOUT_v11.md,"=== MEDIDAS ===

** Total de Estudiantes OUT **
Número total de estudiantes de Unizar que realizan una estancia temporal en otra universidad, en el marco d los acuerdos bilaterales o programas de movilidad suscritos por Unizar.

>Nota: el intercambio debe ir asociado a algún tipo de reconocimiento académico.

** Duración media de las estancias (meses) **
Media aritmética de los meses que dura la estancia de movilidad realizada por los estudiantes de Unizar en o universidad.

>Nota: se incluyen los datos de aquellas estancias que tienen informados en SIGMA todos los datos
correspondientes a la solicitud del alumno, a la asignación de plaza y al contrato de estudios.",section,674,125,0,674
info_cubo_estudiantesOUT_v11.md,=== DIMENSIONES ===,section,20,3,675,695
info_cubo_estudiantesOUT_v11.md,"## DIMENSION: Alumno ##

Atributos:
• Nacionalidad:
Permite clasificar los datos en función de la nacionalidad legal de los estudiantes.

• Rango de Edad:
Permite clasificar los datos en función de los rangos de edad de los estudiantes a fecha 31 de diciembre del curso académico en que están matriculados.

>Valores posibles: 18 años o menos, 19, 20, 21, 22, 23, 24, 25, 26, 27, 28, 29, 30 a 34, 35 a 39, 40 a 44, 45 a 4
50 a 54, 55 a 59, 60 a 64, 65 años o más.

• Residencia Familiar:
Identifica el país, la comunidad autónoma, la provincia o la población de residencia familiar informada por los estudiantes.

• Sexo:
Permite agrupar a los estudiantes en función de su sexo.",section,679,160,696,1375
info_cubo_estudiantesOUT_v11.md,"## DIMENSION: CURSO ACADÉMICO ##

Notas generales:
- Clasifica los datos en función del curso académico en que los estudiantes realizan su estancia de movilidad.

>Nota: El primer curso académico del que constan datos es el 2008/09.",section,233,45,1376,1609
info_cubo_estudiantesOUT_v11.md,"## DIMENSION: Centro ##

Notas generales:
- Permite clasificar los datos en función del centro de la UZ en que los estudiantes están matriculados en el cur académico en que realizan su estancia de movilidad.",section,208,40,1610,1818
info_cubo_estudiantesOUT_v11.md,"## DIMENSION: Expediente ##

Atributos:
• Créditos Superados:
Permite identificar los rangos de créditos superados por los estudiantes durante su estancia.

>Valores posibles: 0 créditos, de 1 a 20 créditos, de 21 a 40 créditos, etc.

• Créditos Superados Previos:
Permite identificar los rangos de créditos superados por los estudiantes en la UZ previamente a realizar su solicitud.

>Valores posibles: 0 créditos, de 1 a 50 créditos, de 51 a 100 créditos, de 101 a 150, de 151 a 200, etc.

• Cursos Matriculados Previos:
Permite clasificar los datos en función del número de cursos académicos en que han estado matriculados los estudiantes en la UZ, antes del curso en que realizan la estancia de movilidad.",section,710,141,1819,2529
info_cubo_estudiantesOUT_v11.md,"## DIMENSION: Fecha de actualización ##

Notas generales:
- Indica la fecha de la última recarga de datos. Habitualmente se realiza el domingo anterior a la fecha de consulta de datos.",section,185,37,2530,2715
info_cubo_estudiantesOUT_v11.md,"## DIMENSION: Movilidad ##

Atributos:
• Nivel de estudios:
Permite identificar el nivel formativo de los estudiantes que realizan la movilidad. Valores posibles: Undergraduate, Undergraduate/Postgraduate, Undergraduate/Doctoral, Undergraduate/Postgraduate/Doctoral, Postgraduate, Postgraduate/Doctoral, Doctoral.

>Nota: se incluyen los datos de aquellas estancias que tienen informados en SIGMA todos los datos
correspondientes a la solicitud del alumno, a la asignación de plaza y al contrato de estudios (para el resto de los casos figura “No informado”).

• Orden de preferencia:
Permite clasificar los datos en función del orden de preferencia en que figura la movilidad realizada en las solicitudes presentadas por los estudiantes.

>Nota: se incluyen los datos de aquellas estancias que tienen informados en SIGMA todos los datos
correspondientes a la solicitud del alumno, a la asignación de plaza y al contrato de estudios. Para el resto de los casos figura el valor 1.

• País de la Universidad de Destino:
Permite clasificar los datos en función de los países de pertenencia de las universidades de destino de los estudiantes.

• Programa de Movilidad:
Permite clasificar los datos en función del programa de movilidad en virtud del cual se realiza la estancia. Esta dimensión tiene tres atributos: • “Programa Internacional (S/N)”: distingue los programas de movilidad internacionales (S) de los que lo son (N), como el SICUE. • “Tipo de programa de movilidad”. Valores posibles: Erasmus, SICUE-SÉNECA, Movilidad en másteres (AGE), Otras Dentro de la UE y Otras Fuera de la UE. • “Programa de movilidad”: indica el programa concreto en virtud del cual el alumno realiza la estancia tiene entre otros los siguientes valores: Erasmus, SICUE, Movilidad Transfronteriza, Movilidad Iberoamérica, UZ/Norteamérica, Oceanía y Asia, Doble titulación Máster FEGP, Movilidad UE-Suiza, UZ/Brasil, Americampus, Bancaja, etc.

• Universidad de Destino:
Permite clasificar los datos en función de las universidades en las que los estudiantes realizan la estancia.

• Universidad de Destino UNITA (S/N):
Permite clasificar los datos en función de si la universidad de destino de los estudiantes pertenece a la alianza de universidades europeas UNITA (S) o no (N).

>El primer curso académico en que están registradas universidades UNITA es 2020/21.

• Área de Estudios:
Permite identificar el área para la que se establece el acuerdo de movilidad en virtud del cual se establecen la estancias realizadas por los estudiantes.

>Nota: se incluyen los datos de aquellas estancias que tienen informados en SIGMA todos los datos
correspondientes a la solicitud del alumno, a la asignación de plaza y al contrato de estudios (para el resto de los casos figura “No informado”).",section,2768,510,2716,5484
info_cubo_estudiantesOUT_v11.md,"## DIMENSION: Titulación ##

Atributos:
• Estudio:
Permite clasificar los datos en función del estudio cursado en Unizar. Es adecuado si queremos agrupar los datos de los estudios que se imparten en varias localidades (ejemplo: ADE, Enfermería, Magisterio, Medicina, etc.).

• Plan de Estudios:
Permite clasificar los datos en función del plan de estudios (código y denominación) de Unizar en que se matriculan los estudiantes.

• Rama de Conocimiento:
Permite clasificar los datos en función de la Rama de Conocimiento (Artes y Humanidades, Ciencias, Ciencias Sociales y Jurídicas, Ciencias de la Salud, Ingeniería y Arquitectura) a la que pertenece el estudio de Unizar en que se matriculan los estudiantes.

• Tipo de estudio:
Permite identificar el tipo de estudio cursado por los estudiantes en Unizar: grado, máster, doctorado. Con anterioridad al curso 2014/15 se muestran también licenciatura o equivalente, diplomatura o equivalent",section,942,174,5485,6427
info_cubo_estudiantesOUT_v11.md,=== MEDIDAS ===,paragraph,15,3,0,15
info_cubo_estudiantesOUT_v11.md,"** Total de Estudiantes OUT **
Número total de estudiantes de Unizar que realizan una estancia temporal en otra universidad, en el marco d los acuerdos bilaterales o programas de movilidad suscritos por Unizar.",paragraph,210,38,17,227
info_cubo_estudiantesOUT_v11.md,>Nota: el intercambio debe ir asociado a algún tipo de reconocimiento académico.,paragraph,80,15,229,309
info_cubo_estudiantesOUT_v11.md,"** Duración media de las estancias (meses) **
Media aritmética de los meses que dura la estancia de movilidad realizada por los estudiantes de Unizar en o universidad.",paragraph,167,33,311,478
info_cubo_estudiantesOUT_v11.md,">Nota: se incluyen los datos de aquellas estancias que tienen informados en SIGMA todos los datos
correspondientes a la solicitud del alumno, a la asignación de plaza y al contrato de estudios.",paragraph,193,36,480,673
info_cubo_estudiantesOUT_v11.md,=== DIMENSIONES ===,paragraph,19,3,675,694
info_cubo_estudiantesOUT_v11.md,## DIMENSION: Alumno ##,paragraph,23,7,696,719
info_cubo_estudiantesOUT_v11.md,"Atributos:
• Nacionalidad:
Permite clasificar los datos en función de la nacionalidad legal de los estudiantes.",paragraph,111,19,721,832
info_cubo_estudiantesOUT_v11.md,"• Rango de Edad:
Permite clasificar los datos en función de los rangos de edad de los estudiantes a fecha 31 de diciembre del curso académico en que están matriculados.",paragraph,168,32,834,1002
info_cubo_estudiantesOUT_v11.md,">Valores posibles: 18 años o menos, 19, 20, 21, 22, 23, 24, 25, 26, 27, 28, 29, 30 a 34, 35 a 39, 40 a 44, 45 a 4
50 a 54, 55 a 59, 60 a 64, 65 años o más.",paragraph,155,63,1004,1159
info_cubo_estudiantesOUT_v11.md,"• Residencia Familiar:
Identifica el país, la comunidad autónoma, la provincia o la población de residencia familiar informada por los estudiantes.",paragraph,147,25,1161,1308
info_cubo_estudiantesOUT_v11.md,"• Sexo:
Permite agrupar a los estudiantes en función de su sexo.",paragraph,64,14,1310,1374
info_cubo_estudiantesOUT_v11.md,## DIMENSION: CURSO ACADÉMICO ##,paragraph,32,8,1376,1408
info_cubo_estudiantesOUT_v11.md,"Notas generales:
- Clasifica los datos en función del curso académico en que los estudiantes realizan su estancia de movilidad.",paragraph,127,22,1410,1537
info_cubo_estudiantesOUT_v11.md,>Nota: El primer curso académico del que constan datos es el 2008/09.,paragraph,69,15,1539,1608
info_cubo_estudiantesOUT_v11.md,## DIMENSION: Centro ##,paragraph,23,7,1610,1633
info_cubo_estudiantesOUT_v11.md,"Notas generales:
- Permite clasificar los datos en función del centro de la UZ en que los estudiantes están matriculados en el cur académico en que realizan su estancia de movilidad.",paragraph,182,33,1635,1817
info_cubo_estudiantesOUT_v11.md,## DIMENSION: Expediente ##,paragraph,27,7,1819,1846
info_cubo_estudiantesOUT_v11.md,"Atributos:
• Créditos Superados:
Permite identificar los rangos de créditos superados por los estudiantes durante su estancia.",paragraph,126,20,1848,1974
info_cubo_estudiantesOUT_v11.md,">Valores posibles: 0 créditos, de 1 a 20 créditos, de 21 a 40 créditos, etc.",paragraph,76,21,1976,2052
info_cubo_estudiantesOUT_v11.md,"• Créditos Superados Previos:
Permite identificar los rangos de créditos superados por los estudiantes en la UZ previamente a realizar su solicitud.",paragraph,148,24,2054,2202
info_cubo_estudiantesOUT_v11.md,">Valores posibles: 0 créditos, de 1 a 50 créditos, de 51 a 100 créditos, de 101 a 150, de 151 a 200, etc.",paragraph,105,31,2204,2309
info_cubo_estudiantesOUT_v11.md,"• Cursos Matriculados Previos:
Permite clasificar los datos en función del número de cursos académicos en que han estado matriculados los estudiantes en la UZ, antes del curso en que realizan la estancia de movilidad.",paragraph,217,38,2311,2528
info_cubo_estudiantesOUT_v11.md,## DIMENSION: Fecha de actualización ##,paragraph,39,9,2530,2569
info_cubo_estudiantesOUT_v11.md,"Notas generales:
- Indica la fecha de la última recarga de datos. Habitualmente se realiza el domingo anterior a la fecha de consulta de datos.",paragraph,143,28,2571,2714
info_cubo_estudiantesOUT_v11.md,## DIMENSION: Movilidad ##,paragraph,26,7,2716,2742
info_cubo_estudiantesOUT_v11.md,"Atributos:
• Nivel de estudios:
Permite identificar el nivel formativo de los estudiantes que realizan la movilidad. Valores posibles: Undergraduate, Undergraduate/Postgraduate, Undergraduate/Doctoral, Undergraduate/Postgraduate/Doctoral, Postgraduate, Postgraduate/Doctoral, Doctoral.",paragraph,285,37,2744,3029
info_cubo_estudiantesOUT_v11.md,">Nota: se incluyen los datos de aquellas estancias que tienen informados en SIGMA todos los datos
correspondientes a la solicitud del alumno, a la asignación de plaza y al contrato de estudios (para el resto de los casos figura “No informado”).",paragraph,244,49,3031,3275
info_cubo_estudiantesOUT_v11.md,"• Orden de preferencia:
Permite clasificar los datos en función del orden de preferencia en que figura la movilidad realizada en las solicitudes presentadas por los estudiantes.",paragraph,177,29,3277,3454
info_cubo_estudiantesOUT_v11.md,">Nota: se incluyen los datos de aquellas estancias que tienen informados en SIGMA todos los datos
correspondientes a la solicitud del alumno, a la asignación de plaza y al contrato de estudios. Para el resto de los casos figura el valor 1.",paragraph,239,47,3456,3695
info_cubo_estudiantesOUT_v11.md,"• País de la Universidad de Destino:
Permite clasificar los datos en función de los países de pertenencia de las universidades de destino de los estudiantes.",paragraph,157,28,3697,3854
info_cubo_estudiantesOUT_v11.md,"• Programa de Movilidad:
Permite clasificar los datos en función del programa de movilidad en virtud del cual se realiza la estancia. Esta dimensión tiene tres atributos: • “Programa Internacional (S/N)”: distingue los programas de movilidad internacionales (S) de los que lo son (N), como el SICUE. • “Tipo de programa de movilidad”. Valores posibles: Erasmus, SICUE-SÉNECA, Movilidad en másteres (AGE), Otras Dentro de la UE y Otras Fuera de la UE. • “Programa de movilidad”: indica el programa concreto en virtud del cual el alumno realiza la estancia tiene entre otros los siguientes valores: Erasmus, SICUE, Movilidad Transfronteriza, Movilidad Iberoamérica, UZ/Norteamérica, Oceanía y Asia, Doble titulación Máster FEGP, Movilidad UE-Suiza, UZ/Brasil, Americampus, Bancaja, etc.",paragraph,784,155,3856,4640
info_cubo_estudiantesOUT_v11.md,"• Universidad de Destino:
Permite clasificar los datos en función de las universidades en las que los estudiantes realizan la estancia.",paragraph,135,23,4642,4777
info_cubo_estudiantesOUT_v11.md,"• Universidad de Destino UNITA (S/N):
Permite clasificar los datos en función de si la universidad de destino de los estudiantes pertenece a la alianza de universidades europeas UNITA (S) o no (N).",paragraph,197,41,4779,4976
info_cubo_estudiantesOUT_v11.md,>El primer curso académico en que están registradas universidades UNITA es 2020/21.,paragraph,83,14,4978,5061
info_cubo_estudiantesOUT_v11.md,"• Área de Estudios:
Permite identificar el área para la que se establece el acuerdo de movilidad en virtud del cual se establecen la estancias realizadas por los estudiantes.",paragraph,174,31,5063,5237
info_cubo_estudiantesOUT_v11.md,">Nota: se incluyen los datos de aquellas estancias que tienen informados en SIGMA todos los datos
correspondientes a la solicitud del alumno, a la asignación de plaza y al contrato de estudios (para el resto de los casos figura “No informado”).",paragraph,244,49,5239,5483
info_cubo_estudiantesOUT_v11.md,## DIMENSION: Titulación ##,paragraph,27,7,5485,5512
info_cubo_estudiantesOUT_v11.md,"Atributos:
• Estudio:
Permite clasificar los datos en función del estudio cursado en Unizar. Es adecuado si queremos agrupar los datos de los estudios que se imparten en varias localidades (ejemplo: ADE, Enfermería, Magisterio, Medicina, etc.).",paragraph,244,48,5514,5758
info_cubo_estudiantesOUT_v11.md,"• Plan de Estudios:
Permite clasificar los datos en función del plan de estudios (código y denominación) de Unizar en que se matriculan los estudiantes.",paragraph,152,29,5760,5912
info_cubo_estudiantesOUT_v11.md,"• Rama de Conocimiento:
Permite clasificar los datos en función de la Rama de Conocimiento (Artes y Humanidades, Ciencias, Ciencias Sociales y Jurídicas, Ciencias de la Salud, Ingeniería y Arquitectura) a la que pertenece el estudio de Unizar en que se matriculan los estudiantes.",paragraph,280,52,5914,6194
info_cubo_estudiantesOUT_v11.md,"• Tipo de estudio:
Permite identificar el tipo de estudio cursado por los estudiantes en Unizar: grado, máster, doctorado. Con anterioridad al curso 2014/15 se muestran también licenciatura o equivalente, diplomatura o equivalent",paragraph,229,39,6196,6425
info_cubo_estudiantesOUT_v11.md,"=== MEDIDAS ===

** Total de Estudiantes OUT **
Número total de estudiantes de Unizar que realizan una estancia temporal en otra universidad, en el marco d los acuerdos bilaterales o programas de movilidad suscritos por Unizar.",sentence,227,41,0,227
info_cubo_estudiantesOUT_v11.md,>Nota: el intercambio debe ir asociado a algún tipo de reconocimiento académico.,sentence,80,15,227,307
info_cubo_estudiantesOUT_v11.md,"** Duración media de las estancias (meses) **
Media aritmética de los meses que dura la estancia de movilidad realizada por los estudiantes de Unizar en o universidad.",sentence,167,33,309,476
info_cubo_estudiantesOUT_v11.md,">Nota: se incluyen los datos de aquellas estancias que tienen informados en SIGMA todos los datos
correspondientes a la solicitud del alumno, a la asignación de plaza y al contrato de estudios.",sentence,193,36,478,671
info_cubo_estudiantesOUT_v11.md,"=== DIMENSIONES ===

## DIMENSION: Alumno ##

Atributos:
• Nacionalidad:
Permite clasificar los datos en función de la nacionalidad legal de los estudiantes.",sentence,157,29,673,830
info_cubo_estudiantesOUT_v11.md,"• Rango de Edad:
Permite clasificar los datos en función de los rangos de edad de los estudiantes a fecha 31 de diciembre del curso académico en que están matriculados.",sentence,168,32,832,1000
info_cubo_estudiantesOUT_v11.md,">Valores posibles: 18 años o menos, 19, 20, 21, 22, 23, 24, 25, 26, 27, 28, 29, 30 a 34, 35 a 39, 40 a 44, 45 a 4
50 a 54, 55 a 59, 60 a 64, 65 años o más.",sentence,155,63,1002,1157
info_cubo_estudiantesOUT_v11.md,"• Residencia Familiar:
Identifica el país, la comunidad autónoma, la provincia o la población de residencia familiar informada por los estudiantes.",sentence,147,25,1159,1306
info_cubo_estudiantesOUT_v11.md,"• Sexo:
Permite agrupar a los estudiantes en función de su sexo.",sentence,64,14,1308,1372
info_cubo_estudiantesOUT_v11.md,"## DIMENSION: CURSO ACADÉMICO ##

Notas generales:
- Clasifica los datos en función del curso académico en que los estudiantes realizan su estancia de movilidad.",sentence,161,30,1374,1535
info_cubo_estudiantesOUT_v11.md,>Nota: El primer curso académico del que constan datos es el 2008/09.,sentence,69,15,1537,1606
info_cubo_estudiantesOUT_v11.md,"## DIMENSION: Centro ##

Notas generales:
- Permite clasificar los datos en función del centro de la UZ en que los estudiantes están matriculados en el cur académico en que realizan su estancia de movilidad.",sentence,207,40,1608,1815
info_cubo_estudiantesOUT_v11.md,"## DIMENSION: Expediente ##

Atributos:
• Créditos Superados:
Permite identificar los rangos de créditos superados por los estudiantes durante su estancia.",sentence,155,27,1817,1972
info_cubo_estudiantesOUT_v11.md,">Valores posibles: 0 créditos, de 1 a 20 créditos, de 21 a 40 créditos, etc.",sentence,76,21,1974,2050
info_cubo_estudiantesOUT_v11.md,"• Créditos Superados Previos:
Permite identificar los rangos de créditos superados por los estudiantes en la UZ previamente a realizar su solicitud.",sentence,148,24,2052,2200
info_cubo_estudiantesOUT_v11.md,">Valores posibles: 0 créditos, de 1 a 50 créditos, de 51 a 100 créditos, de 101 a 150, de 151 a 200, etc.",sentence,105,31,2202,2307
info_cubo_estudiantesOUT_v11.md,"• Cursos Matriculados Previos:
Permite clasificar los datos en función del número de cursos académicos en que han estado matriculados los estudiantes en la UZ, antes del curso en que realizan la estancia de movilidad.",sentence,217,38,2309,2526
info_cubo_estudiantesOUT_v11.md,"## DIMENSION: Fecha de actualización ##

Notas generales:
- Indica la fecha de la última recarga de datos.",sentence,106,23,2528,2634
info_cubo_estudiantesOUT_v11.md,Habitualmente se realiza el domingo anterior a la fecha de consulta de datos.,sentence,77,14,2636,2713
info_cubo_estudiantesOUT_v11.md,"## DIMENSION: Movilidad ##

Atributos:
• Nivel de estudios:
Permite identificar el nivel formativo de los estudiantes que realizan la movilidad.",sentence,144,27,2714,2858
info_cubo_estudiantesOUT_v11.md,"Valores posibles: Undergraduate, Undergraduate/Postgraduate, Undergraduate/Doctoral, Undergraduate/Postgraduate/Doctoral, Postgraduate, Postgraduate/Doctoral, Doctoral.",sentence,168,17,2860,3028
info_cubo_estudiantesOUT_v11.md,">Nota: se incluyen los datos de aquellas estancias que tienen informados en SIGMA todos los datos
correspondientes a la solicitud del alumno, a la asignación de plaza y al contrato de estudios (para el resto de los casos figura “No informado”).",sentence,244,49,3029,3273
info_cubo_estudiantesOUT_v11.md,"• Orden de preferencia:
Permite clasificar los datos en función del orden de preferencia en que figura la movilidad realizada en las solicitudes presentadas por los estudiantes.",sentence,177,29,3275,3452
info_cubo_estudiantesOUT_v11.md,">Nota: se incluyen los datos de aquellas estancias que tienen informados en SIGMA todos los datos
correspondientes a la solicitud del alumno, a la asignación de plaza y al contrato de estudios.",sentence,193,36,3454,3647
info_cubo_estudiantesOUT_v11.md,Para el resto de los casos figura el valor 1.,sentence,45,11,3649,3694
info_cubo_estudiantesOUT_v11.md,"• País de la Universidad de Destino:
Permite clasificar los datos en función de los países de pertenencia de las universidades de destino de los estudiantes.",sentence,157,28,3695,3852
info_cubo_estudiantesOUT_v11.md,"• Programa de Movilidad:
Permite clasificar los datos en función del programa de movilidad en virtud del cual se realiza la estancia.",sentence,133,24,3854,3987
info_cubo_estudiantesOUT_v11.md,"Esta dimensión tiene tres atributos: • “Programa Internacional (S/N)”: distingue los programas de movilidad internacionales (S) de los que lo son (N), como el SICUE.",sentence,165,37,3989,4154
info_cubo_estudiantesOUT_v11.md,• “Tipo de programa de movilidad”.,sentence,34,9,4155,4189
info_cubo_estudiantesOUT_v11.md,"Valores posibles: Erasmus, SICUE-SÉNECA, Movilidad en másteres (AGE), Otras Dentro de la UE y Otras Fuera de la UE.",sentence,115,26,4190,4305
info_cubo_estudiantesOUT_v11.md,"• “Programa de movilidad”: indica el programa concreto en virtud del cual el alumno realiza la estancia tiene entre otros los siguientes valores: Erasmus, SICUE, Movilidad Transfronteriza, Movilidad Iberoamérica, UZ/Norteamérica, Oceanía y Asia, Doble titulación Máster FEGP, Movilidad UE-Suiza, UZ/Brasil, Americampus, Bancaja, etc.",sentence,333,59,4306,4639
info_cubo_estudiantesOUT_v11.md,"• Universidad de Destino:
Permite clasificar los datos en función de las universidades en las que los estudiantes realizan la estancia.",sentence,135,23,4640,4775
info_cubo_estudiantesOUT_v11.md,"• Universidad de Destino UNITA (S/N):
Permite clasificar los datos en función de si la universidad de destino de los estudiantes pertenece a la alianza de universidades europeas UNITA (S) o no (N).",sentence,197,41,4777,4974
info_cubo_estudiantesOUT_v11.md,>El primer curso académico en que están registradas universidades UNITA es 2020/21.,sentence,83,14,4976,5059
info_cubo_estudiantesOUT_v11.md,"• Área de Estudios:
Permite identificar el área para la que se establece el acuerdo de movilidad en virtud del cual se establecen la estancias realizadas por los estudiantes.",sentence,174,31,5061,5235
info_cubo_estudiantesOUT_v11.md,">Nota: se incluyen los datos de aquellas estancias que tienen informados en SIGMA todos los datos
correspondientes a la solicitud del alumno, a la asignación de plaza y al contrato de estudios (para el resto de los casos figura “No informado”).",sentence,244,49,5237,5481
info_cubo_estudiantesOUT_v11.md,"## DIMENSION: Titulación ##

Atributos:
• Estudio:
Permite clasificar los datos en función del estudio cursado en Unizar.",sentence,121,24,5483,5604
info_cubo_estudiantesOUT_v11.md,"Es adecuado si queremos agrupar los datos de los estudios que se imparten en varias localidades (ejemplo: ADE, Enfermería, Magisterio, Medicina, etc.).",sentence,151,31,5606,5757
info_cubo_estudiantesOUT_v11.md,"• Plan de Estudios:
Permite clasificar los datos en función del plan de estudios (código y denominación) de Unizar en que se matriculan los estudiantes.",sentence,152,29,5758,5910
info_cubo_estudiantesOUT_v11.md,"• Rama de Conocimiento:
Permite clasificar los datos en función de la Rama de Conocimiento (Artes y Humanidades, Ciencias, Ciencias Sociales y Jurídicas, Ciencias de la Salud, Ingeniería y Arquitectura) a la que pertenece el estudio de Unizar en que se matriculan los estudiantes.",sentence,280,52,5912,6192
info_cubo_estudiantesOUT_v11.md,"• Tipo de estudio:
Permite identificar el tipo de estudio cursado por los estudiantes en Unizar: grado, máster, doctorado.",sentence,122,24,6194,6316
info_cubo_estudiantesOUT_v11.md,"Con anterioridad al curso 2014/15 se muestran también licenciatura o equivalente, diplomatura o equivalent",sentence,106,15,6318,6424
info_cubo_grupos_v13.md,"=== MEDIDAS ===

** Número de grupos **
Número de grupos de investigación constituidos.

>Se recomienda incorporar a la consulta la dimensión ‘año’. De lo contrario se mostrarán los acumulados de
todos los años desde que existen datos.

** Número de investigadores **
Número de investigadores en la Universidad de Zaragoza que pertenecen a un grupo de investigación.

>Se recomienda incorporar a la consulta la dimensión ‘año’. De lo contrario se mostrarán los acumulados de
todos los años desde que existen datos.

** Importe anual concedido **
Informa sobre las subvenciones recibidas por cada uno de los grupos.

>Se recomienda incorporar a la consulta la dimensión ‘año’. De lo contrario se mostrarán los acumulados de
todos los años desde que existen datos.",section,763,146,0,763
info_cubo_grupos_v13.md,=== DIMENSIONES ===,section,20,3,764,784
info_cubo_grupos_v13.md,"## DIMENSION: AÑO ##

Notas generales:
- Permite ubicar en el tiempo la relación de los investigadores con la UZ. Los datos por AÑO acumulan los investigadores existentes a fecha último día de todos los meses del año seleccionado (si el año seleccionado un año en curso, se acumulan los efectivos existentes a fecha último día de los meses anteriores y para el m en curso los efectivos existentes a la fecha de la última carga).",section,429,85,785,1214
info_cubo_grupos_v13.md,"## DIMENSION: Fecha de actualización ##

Notas generales:
- Es la fecha y hora de la última recarga de datos.",section,110,25,1215,1325
info_cubo_grupos_v13.md,"## DIMENSION: Grupo ##

Atributos:
• Centro:
Permite clasificar los grupos de investigación en función del centro al que pertenece el investigador principa

• Denominación:
Permite clasificar los datos en función del grupo de investigación al que pertenecen los investigadores.

• Departamento:
Permite clasificar los grupos de investigación en función del departamento al que está adscrito el investigad principal.

• Gestionado por UNIZAR (S/N):
Permite clasificar los datos en función de si el grupo de investigación es gestionado desde la UZ (S) o es exte a la misma (N).

• Instituto:
Permite clasificar los grupos de investigación en función del instituto universitario de investigación (IUI) al q pertenece el investigador principal del grupo. Si no pertenece a ningún IUI, figura “No informado”.

• Macroárea:
Permite clasificar los grupos de investigación en función de la macroárea a la que pertenece el investigador principal.

>Valores posibles: Artes y Humanidades, Ciencias, Ciencias Sociales y Jurídicas, Ciencias de la Salud, Ingenier
Arquitectura.

• Tipo:
Permite agrupar a los investigadores en función de la tipología del grupo de investigación al que, en su caso, pertenecen.

>Valores posibles: Emergente, Consolidado, Consolidado de Investigación Aplicada, Excelente.

• Área:
Permite clasificar los grupos de investigación en función del área de conocimiento a la que está adscrito el investigador principal del grupo.",section,1443,259,1326,2769
info_cubo_grupos_v13.md,"## DIMENSION: Investigador ##

Atributos:
• Categoría:
Permite clasificar a los investigadores en función de la categoría que figura en su contrato de investigador.

• Centro:
Permite clasificar los datos en función del centro al que pertenecen los investigadores.

• Cuerpo/Escala:
Permite clasificar los datos en función de la categoría/cuerpo/escala a la que pertenecen los investigadores.

• Doctor (S/N):
Permite clasificar a los investigadores en función de si figuran como Doctor en las bases de datos de persona (S) o no (N).

• Edad:
Permite agrupar los rangos de edad de los investigadores en función de su fecha de nacimiento.

>Valores posibles: 20 años o menos, 21 a 30, 31 a 40, 41 a 50, 51 a 60, 60 años o más.

• Nacionalidad:
Permite clasificar los datos en función de la nacionalidad legal de los investigadores.

• Nivel formativo:
Permite clasificar los datos en función del nivel formativo de los investigadores.

>Valores posibles: bachiller elemental o equivalente, bachiller superior o equivalente, diplomados o
equivalente, licenciados o equivalente, Máster (EEES), Doctor.

• Responsable de Grupo (S/N):
Permite agrupar a los investigadores en función de si son responsables de su grupo de investigación (S) o no (N).

• Sexenios Estatales:
Permite clasificar los datos en función del número de sexenios o tramos de investigación reconocidos por la CNEAI a los investigadores. Se incluyen tanto los reconocidos a los cuerpos de funcionarios docentes universitarios como al personal contratado.

• Sexo:
Permite agrupar a los investigadores en función de su sexo.

>Observación: se recomienda no cruzar esta dimensión con la medida “grupo”, ya que éste está formado po
muchos investigadores. Si se desea conocer el sexo de los responsables del grupo se debe introducir en la consulta la dimensión “responsable del grupo” y filtrarla por el valor S.

• Tipo de miembro en el grupo de investigación:
Permite agrupar a los investigadores en función de si pertenecen a un grupo de investigación en calidad de investigador principal, colaborador, becario o externo a la UZ.",section,2095,398,2770,4865
info_cubo_grupos_v13.md,=== MEDIDAS ===,paragraph,15,3,0,15
info_cubo_grupos_v13.md,"** Número de grupos **
Número de grupos de investigación constituidos.",paragraph,70,14,17,87
info_cubo_grupos_v13.md,">Se recomienda incorporar a la consulta la dimensión ‘año’. De lo contrario se mostrarán los acumulados de
todos los años desde que existen datos.",paragraph,146,29,89,235
info_cubo_grupos_v13.md,"** Número de investigadores **
Número de investigadores en la Universidad de Zaragoza que pertenecen a un grupo de investigación.",paragraph,129,23,237,366
info_cubo_grupos_v13.md,">Se recomienda incorporar a la consulta la dimensión ‘año’. De lo contrario se mostrarán los acumulados de
todos los años desde que existen datos.",paragraph,146,29,368,514
info_cubo_grupos_v13.md,"** Importe anual concedido **
Informa sobre las subvenciones recibidas por cada uno de los grupos.",paragraph,98,19,516,614
info_cubo_grupos_v13.md,">Se recomienda incorporar a la consulta la dimensión ‘año’. De lo contrario se mostrarán los acumulados de
todos los años desde que existen datos.",paragraph,146,29,616,762
info_cubo_grupos_v13.md,=== DIMENSIONES ===,paragraph,19,3,764,783
info_cubo_grupos_v13.md,## DIMENSION: AÑO ##,paragraph,20,7,785,805
info_cubo_grupos_v13.md,"Notas generales:
- Permite ubicar en el tiempo la relación de los investigadores con la UZ. Los datos por AÑO acumulan los investigadores existentes a fecha último día de todos los meses del año seleccionado (si el año seleccionado un año en curso, se acumulan los efectivos existentes a fecha último día de los meses anteriores y para el m en curso los efectivos existentes a la fecha de la última carga).",paragraph,406,78,807,1213
info_cubo_grupos_v13.md,## DIMENSION: Fecha de actualización ##,paragraph,39,9,1215,1254
info_cubo_grupos_v13.md,"Notas generales:
- Es la fecha y hora de la última recarga de datos.",paragraph,68,16,1256,1324
info_cubo_grupos_v13.md,## DIMENSION: Grupo ##,paragraph,22,7,1326,1348
info_cubo_grupos_v13.md,"Atributos:
• Centro:
Permite clasificar los grupos de investigación en función del centro al que pertenece el investigador principa",paragraph,131,21,1350,1481
info_cubo_grupos_v13.md,"• Denominación:
Permite clasificar los datos en función del grupo de investigación al que pertenecen los investigadores.",paragraph,120,19,1483,1603
info_cubo_grupos_v13.md,"• Departamento:
Permite clasificar los grupos de investigación en función del departamento al que está adscrito el investigad principal.",paragraph,136,21,1605,1741
info_cubo_grupos_v13.md,"• Gestionado por UNIZAR (S/N):
Permite clasificar los datos en función de si el grupo de investigación es gestionado desde la UZ (S) o es exte a la misma (N).",paragraph,158,38,1743,1901
info_cubo_grupos_v13.md,"• Instituto:
Permite clasificar los grupos de investigación en función del instituto universitario de investigación (IUI) al q pertenece el investigador principal del grupo. Si no pertenece a ningún IUI, figura “No informado”.",paragraph,226,41,1903,2129
info_cubo_grupos_v13.md,"• Macroárea:
Permite clasificar los grupos de investigación en función de la macroárea a la que pertenece el investigador principal.",paragraph,132,22,2131,2263
info_cubo_grupos_v13.md,">Valores posibles: Artes y Humanidades, Ciencias, Ciencias Sociales y Jurídicas, Ciencias de la Salud, Ingenier
Arquitectura.",paragraph,125,23,2265,2390
info_cubo_grupos_v13.md,"• Tipo:
Permite agrupar a los investigadores en función de la tipología del grupo de investigación al que, en su caso, pertenecen.",paragraph,130,26,2392,2522
info_cubo_grupos_v13.md,">Valores posibles: Emergente, Consolidado, Consolidado de Investigación Aplicada, Excelente.",paragraph,92,15,2524,2616
info_cubo_grupos_v13.md,"• Área:
Permite clasificar los grupos de investigación en función del área de conocimiento a la que está adscrito el investigador principal del grupo.",paragraph,150,26,2618,2768
info_cubo_grupos_v13.md,## DIMENSION: Investigador ##,paragraph,29,7,2770,2799
info_cubo_grupos_v13.md,"Atributos:
• Categoría:
Permite clasificar a los investigadores en función de la categoría que figura en su contrato de investigador.",paragraph,133,23,2801,2934
info_cubo_grupos_v13.md,"• Centro:
Permite clasificar los datos en función del centro al que pertenecen los investigadores.",paragraph,98,17,2936,3034
info_cubo_grupos_v13.md,"• Cuerpo/Escala:
Permite clasificar los datos en función de la categoría/cuerpo/escala a la que pertenecen los investigadores.",paragraph,126,19,3036,3162
info_cubo_grupos_v13.md,"• Doctor (S/N):
Permite clasificar a los investigadores en función de si figuran como Doctor en las bases de datos de persona (S) o no (N).",paragraph,139,34,3164,3303
info_cubo_grupos_v13.md,"• Edad:
Permite agrupar los rangos de edad de los investigadores en función de su fecha de nacimiento.",paragraph,102,20,3305,3407
info_cubo_grupos_v13.md,">Valores posibles: 20 años o menos, 21 a 30, 31 a 40, 41 a 50, 51 a 60, 60 años o más.",paragraph,86,30,3409,3495
info_cubo_grupos_v13.md,"• Nacionalidad:
Permite clasificar los datos en función de la nacionalidad legal de los investigadores.",paragraph,103,17,3497,3600
info_cubo_grupos_v13.md,"• Nivel formativo:
Permite clasificar los datos en función del nivel formativo de los investigadores.",paragraph,101,17,3602,3703
info_cubo_grupos_v13.md,">Valores posibles: bachiller elemental o equivalente, bachiller superior o equivalente, diplomados o
equivalente, licenciados o equivalente, Máster (EEES), Doctor.",paragraph,163,29,3705,3868
info_cubo_grupos_v13.md,"• Responsable de Grupo (S/N):
Permite agrupar a los investigadores en función de si son responsables de su grupo de investigación (S) o no (N).",paragraph,143,33,3870,4013
info_cubo_grupos_v13.md,"• Sexenios Estatales:
Permite clasificar los datos en función del número de sexenios o tramos de investigación reconocidos por la CNEAI a los investigadores. Se incluyen tanto los reconocidos a los cuerpos de funcionarios docentes universitarios como al personal contratado.",paragraph,274,43,4015,4289
info_cubo_grupos_v13.md,"• Sexo:
Permite agrupar a los investigadores en función de su sexo.",paragraph,67,14,4291,4358
info_cubo_grupos_v13.md,">Observación: se recomienda no cruzar esta dimensión con la medida “grupo”, ya que éste está formado po
muchos investigadores. Si se desea conocer el sexo de los responsables del grupo se debe introducir en la consulta la dimensión “responsable del grupo” y filtrarla por el valor S.",paragraph,283,56,4360,4643
info_cubo_grupos_v13.md,"• Tipo de miembro en el grupo de investigación:
Permite agrupar a los investigadores en función de si pertenecen a un grupo de investigación en calidad de investigador principal, colaborador, becario o externo a la UZ.",paragraph,218,40,4645,4863
info_cubo_grupos_v13.md,"=== MEDIDAS ===

** Número de grupos **
Número de grupos de investigación constituidos.",sentence,87,17,0,87
info_cubo_grupos_v13.md,>Se recomienda incorporar a la consulta la dimensión ‘año’.,sentence,59,13,87,146
info_cubo_grupos_v13.md,"De lo contrario se mostrarán los acumulados de
todos los años desde que existen datos.",sentence,86,16,148,234
info_cubo_grupos_v13.md,"** Número de investigadores **
Número de investigadores en la Universidad de Zaragoza que pertenecen a un grupo de investigación.",sentence,129,23,235,364
info_cubo_grupos_v13.md,>Se recomienda incorporar a la consulta la dimensión ‘año’.,sentence,59,13,366,425
info_cubo_grupos_v13.md,"De lo contrario se mostrarán los acumulados de
todos los años desde que existen datos.",sentence,86,16,427,513
info_cubo_grupos_v13.md,"** Importe anual concedido **
Informa sobre las subvenciones recibidas por cada uno de los grupos.",sentence,98,19,514,612
info_cubo_grupos_v13.md,>Se recomienda incorporar a la consulta la dimensión ‘año’.,sentence,59,13,614,673
info_cubo_grupos_v13.md,"De lo contrario se mostrarán los acumulados de
todos los años desde que existen datos.",sentence,86,16,675,761
info_cubo_grupos_v13.md,"=== DIMENSIONES ===

## DIMENSION: AÑO ##

Notas generales:
- Permite ubicar en el tiempo la relación de los investigadores con la UZ.",sentence,134,28,762,896
info_cubo_grupos_v13.md,"Los datos por AÑO acumulan los investigadores existentes a fecha último día de todos los meses del año seleccionado (si el año seleccionado un año en curso, se acumulan los efectivos existentes a fecha último día de los meses anteriores y para el m en curso los efectivos existentes a la fecha de la última carga).",sentence,314,60,898,1212
info_cubo_grupos_v13.md,"## DIMENSION: Fecha de actualización ##

Notas generales:
- Es la fecha y hora de la última recarga de datos.",sentence,109,25,1213,1322
info_cubo_grupos_v13.md,"## DIMENSION: Grupo ##

Atributos:
• Centro:
Permite clasificar los grupos de investigación en función del centro al que pertenece el investigador principa

• Denominación:
Permite clasificar los datos en función del grupo de investigación al que pertenecen los investigadores.",sentence,277,47,1324,1601
info_cubo_grupos_v13.md,"• Departamento:
Permite clasificar los grupos de investigación en función del departamento al que está adscrito el investigad principal.",sentence,136,21,1603,1739
info_cubo_grupos_v13.md,"• Gestionado por UNIZAR (S/N):
Permite clasificar los datos en función de si el grupo de investigación es gestionado desde la UZ (S) o es exte a la misma (N).",sentence,158,38,1741,1899
info_cubo_grupos_v13.md,"• Instituto:
Permite clasificar los grupos de investigación en función del instituto universitario de investigación (IUI) al q pertenece el investigador principal del grupo.",sentence,173,28,1901,2074
info_cubo_grupos_v13.md,"Si no pertenece a ningún IUI, figura “No informado”.",sentence,52,13,2076,2128
info_cubo_grupos_v13.md,"• Macroárea:
Permite clasificar los grupos de investigación en función de la macroárea a la que pertenece el investigador principal.",sentence,132,22,2129,2261
info_cubo_grupos_v13.md,">Valores posibles: Artes y Humanidades, Ciencias, Ciencias Sociales y Jurídicas, Ciencias de la Salud, Ingenier
Arquitectura.",sentence,125,23,2263,2388
info_cubo_grupos_v13.md,"• Tipo:
Permite agrupar a los investigadores en función de la tipología del grupo de investigación al que, en su caso, pertenecen.",sentence,130,26,2390,2520
info_cubo_grupos_v13.md,">Valores posibles: Emergente, Consolidado, Consolidado de Investigación Aplicada, Excelente.",sentence,92,15,2522,2614
info_cubo_grupos_v13.md,"• Área:
Permite clasificar los grupos de investigación en función del área de conocimiento a la que está adscrito el investigador principal del grupo.",sentence,150,26,2616,2766
info_cubo_grupos_v13.md,"## DIMENSION: Investigador ##

Atributos:
• Categoría:
Permite clasificar a los investigadores en función de la categoría que figura en su contrato de investigador.",sentence,164,30,2768,2932
info_cubo_grupos_v13.md,"• Centro:
Permite clasificar los datos en función del centro al que pertenecen los investigadores.",sentence,98,17,2934,3032
info_cubo_grupos_v13.md,"• Cuerpo/Escala:
Permite clasificar los datos en función de la categoría/cuerpo/escala a la que pertenecen los investigadores.",sentence,126,19,3034,3160
info_cubo_grupos_v13.md,"• Doctor (S/N):
Permite clasificar a los investigadores en función de si figuran como Doctor en las bases de datos de persona (S) o no (N).",sentence,139,34,3162,3301
info_cubo_grupos_v13.md,"• Edad:
Permite agrupar los rangos de edad de los investigadores en función de su fecha de nacimiento.",sentence,102,20,3303,3405
info_cubo_grupos_v13.md,">Valores posibles: 20 años o menos, 21 a 30, 31 a 40, 41 a 50, 51 a 60, 60 años o más.",sentence,86,30,3407,3493
info_cubo_grupos_v13.md,"• Nacionalidad:
Permite clasificar los datos en función de la nacionalidad legal de los investigadores.",sentence,103,17,3495,3598
info_cubo_grupos_v13.md,"• Nivel formativo:
Permite clasificar los datos en función del nivel formativo de los investigadores.",sentence,101,17,3600,3701
info_cubo_grupos_v13.md,">Valores posibles: bachiller elemental o equivalente, bachiller superior o equivalente, diplomados o
equivalente, licenciados o equivalente, Máster (EEES), Doctor.",sentence,163,29,3703,3866
info_cubo_grupos_v13.md,"• Responsable de Grupo (S/N):
Permite agrupar a los investigadores en función de si son responsables de su grupo de investigación (S) o no (N).",sentence,143,33,3868,4011
info_cubo_grupos_v13.md,"• Sexenios Estatales:
Permite clasificar los datos en función del número de sexenios o tramos de investigación reconocidos por la CNEAI a los investigadores.",sentence,157,26,4013,4170
info_cubo_grupos_v13.md,Se incluyen tanto los reconocidos a los cuerpos de funcionarios docentes universitarios como al personal contratado.,sentence,116,17,4172,4288
info_cubo_grupos_v13.md,"• Sexo:
Permite agrupar a los investigadores en función de su sexo.",sentence,67,14,4289,4356
info_cubo_grupos_v13.md,">Observación: se recomienda no cruzar esta dimensión con la medida “grupo”, ya que éste está formado po
muchos investigadores.",sentence,126,25,4358,4484
info_cubo_grupos_v13.md,"Si se desea conocer el sexo de los responsables del grupo se debe introducir en la consulta la dimensión “responsable del grupo” y filtrarla por el valor S.

• Tipo de miembro en el grupo de investigación:
Permite agrupar a los investigadores en función de si pertenecen a un grupo de investigación en calidad de investigador principal, colaborador, becario o externo a la UZ.",sentence,376,70,4486,4862
info_cubo_indicesBibliometricos_v11.md,"=== MEDIDAS ===

** Artículos **
Número de artículos publicados.

>Se recomienda incorporar a la consulta la dimensión 'AÑO' para mostrar los datos por año de registro.

** Revistas **
Número de revistas editadas.

>Se recomienda incorporar a la consulta la dimensión 'AÑO' para mostrar los datos por año de registro.

** Factor Impacto **
Indica el factor de impacto JCR de las revistas.",section,389,79,0,389
info_cubo_indicesBibliometricos_v11.md,=== DIMENSIONES ===,section,20,3,390,410
info_cubo_indicesBibliometricos_v11.md,"## DIMENSION: AÑO ##

Notas generales:
- Permite clasificar la producción científica en función del año de su publicación.",section,123,24,411,534
info_cubo_indicesBibliometricos_v11.md,"## DIMENSION: Fecha de actualización ##

Notas generales:
- Es la fecha de la última recarga de datos.",section,103,23,535,638
info_cubo_indicesBibliometricos_v11.md,"## DIMENSION: Investigador ##

Atributos:
• Centro:
Permite clasificar los datos en función del centro al que pertenecen los autores de la publicación.

• Departamento:
Permite clasificar los datos en función del departamento al que están adscritos los autores de la publicación.

• Grupo de Investigación:
Permite clasificar los datos en función del grupo de investigación al que pertenecen los autores de la publicación.

• Instituto de Investigación:
Permite clasificar los datos en función del instituto universitario de investigación al que pertenecen los autores de la publicación.

• Macroárea:
Permite clasificar los datos en función de la macroárea a la que pertenecen los autores de la publicación.

>Valores posibles: Artes y Humanidades, Ciencias, Ciencias Sociales y Jurídicas, Ciencias de la Salud, Ingeniería y
Arquitectura.

• Otros Centros de Investigación:
Permite clasificar los datos en función de si los autores de la publicación pertenecen o no a estructuras de investigación distintas de los institutos universitarios de investigación.

>Ejemplo: IIS ‐ Instituto de Investigación Sanitaria de Aragón.",section,1124,191,639,1763
info_cubo_indicesBibliometricos_v11.md,"## DIMENSION: Revista ##

Atributos:
• Cuartil:
Clasifica las revistas según el cuartil al que pertenecen, dentro del ranking determinado por los factores de impacto según una materia específica.

>Es necesario incorporar a la consulta la dimensión 'AÑO' para mostrar los datos por año de registro.

• Decil:
Clasifica las revistas según el decil al que pertenecen, dentro del ranking determinado por los factores de impacto según una materia específica.

>Es necesario incorporar a la consulta la dimensión 'AÑO' para mostrar los datos por año de registro.

• Materia:
Permite clasificar las revistas según la materia a la que pertenecen.",section,641,118,1764,2405
info_cubo_indicesBibliometricos_v11.md,=== MEDIDAS ===,paragraph,15,3,0,15
info_cubo_indicesBibliometricos_v11.md,"** Artículos **
Número de artículos publicados.",paragraph,47,10,17,64
info_cubo_indicesBibliometricos_v11.md,>Se recomienda incorporar a la consulta la dimensión 'AÑO' para mostrar los datos por año de registro.,paragraph,102,20,66,168
info_cubo_indicesBibliometricos_v11.md,"** Revistas **
Número de revistas editadas.",paragraph,43,10,170,213
info_cubo_indicesBibliometricos_v11.md,>Se recomienda incorporar a la consulta la dimensión 'AÑO' para mostrar los datos por año de registro.,paragraph,102,20,215,317
info_cubo_indicesBibliometricos_v11.md,"** Factor Impacto **
Indica el factor de impacto JCR de las revistas.",paragraph,69,16,319,388
info_cubo_indicesBibliometricos_v11.md,=== DIMENSIONES ===,paragraph,19,3,390,409
info_cubo_indicesBibliometricos_v11.md,## DIMENSION: AÑO ##,paragraph,20,7,411,431
info_cubo_indicesBibliometricos_v11.md,"Notas generales:
- Permite clasificar la producción científica en función del año de su publicación.",paragraph,100,17,433,533
info_cubo_indicesBibliometricos_v11.md,## DIMENSION: Fecha de actualización ##,paragraph,39,9,535,574
info_cubo_indicesBibliometricos_v11.md,"Notas generales:
- Es la fecha de la última recarga de datos.",paragraph,61,14,576,637
info_cubo_indicesBibliometricos_v11.md,## DIMENSION: Investigador ##,paragraph,29,7,639,668
info_cubo_indicesBibliometricos_v11.md,"Atributos:
• Centro:
Permite clasificar los datos en función del centro al que pertenecen los autores de la publicación.",paragraph,120,22,670,790
info_cubo_indicesBibliometricos_v11.md,"• Departamento:
Permite clasificar los datos en función del departamento al que están adscritos los autores de la publicación.",paragraph,126,21,792,918
info_cubo_indicesBibliometricos_v11.md,"• Grupo de Investigación:
Permite clasificar los datos en función del grupo de investigación al que pertenecen los autores de la publicación.",paragraph,141,24,920,1061
info_cubo_indicesBibliometricos_v11.md,"• Instituto de Investigación:
Permite clasificar los datos en función del instituto universitario de investigación al que pertenecen los autores de la publicación.",paragraph,163,25,1063,1226
info_cubo_indicesBibliometricos_v11.md,"• Macroárea:
Permite clasificar los datos en función de la macroárea a la que pertenecen los autores de la publicación.",paragraph,119,22,1228,1347
info_cubo_indicesBibliometricos_v11.md,">Valores posibles: Artes y Humanidades, Ciencias, Ciencias Sociales y Jurídicas, Ciencias de la Salud, Ingeniería y
Arquitectura.",paragraph,129,24,1349,1478
info_cubo_indicesBibliometricos_v11.md,"• Otros Centros de Investigación:
Permite clasificar los datos en función de si los autores de la publicación pertenecen o no a estructuras de investigación distintas de los institutos universitarios de investigación.",paragraph,217,34,1480,1697
info_cubo_indicesBibliometricos_v11.md,>Ejemplo: IIS ‐ Instituto de Investigación Sanitaria de Aragón.,paragraph,63,12,1699,1762
info_cubo_indicesBibliometricos_v11.md,## DIMENSION: Revista ##,paragraph,24,7,1764,1788
info_cubo_indicesBibliometricos_v11.md,"Atributos:
• Cuartil:
Clasifica las revistas según el cuartil al que pertenecen, dentro del ranking determinado por los factores de impacto según una materia específica.",paragraph,169,29,1790,1959
info_cubo_indicesBibliometricos_v11.md,>Es necesario incorporar a la consulta la dimensión 'AÑO' para mostrar los datos por año de registro.,paragraph,101,20,1961,2062
info_cubo_indicesBibliometricos_v11.md,"• Decil:
Clasifica las revistas según el decil al que pertenecen, dentro del ranking determinado por los factores de impacto según una materia específica.",paragraph,154,27,2064,2218
info_cubo_indicesBibliometricos_v11.md,>Es necesario incorporar a la consulta la dimensión 'AÑO' para mostrar los datos por año de registro.,paragraph,101,20,2220,2321
info_cubo_indicesBibliometricos_v11.md,"• Materia:
Permite clasificar las revistas según la materia a la que pertenecen.",paragraph,80,15,2323,2403
info_cubo_indicesBibliometricos_v11.md,"=== MEDIDAS ===

** Artículos **
Número de artículos publicados.",sentence,64,13,0,64
info_cubo_indicesBibliometricos_v11.md,>Se recomienda incorporar a la consulta la dimensión 'AÑO' para mostrar los datos por año de registro.,sentence,102,20,64,166
info_cubo_indicesBibliometricos_v11.md,"** Revistas **
Número de revistas editadas.",sentence,43,10,168,211
info_cubo_indicesBibliometricos_v11.md,>Se recomienda incorporar a la consulta la dimensión 'AÑO' para mostrar los datos por año de registro.,sentence,102,20,213,315
info_cubo_indicesBibliometricos_v11.md,"** Factor Impacto **
Indica el factor de impacto JCR de las revistas.",sentence,69,16,317,386
info_cubo_indicesBibliometricos_v11.md,"=== DIMENSIONES ===

## DIMENSION: AÑO ##

Notas generales:
- Permite clasificar la producción científica en función del año de su publicación.",sentence,143,27,388,531
info_cubo_indicesBibliometricos_v11.md,"## DIMENSION: Fecha de actualización ##

Notas generales:
- Es la fecha de la última recarga de datos.",sentence,102,23,533,635
info_cubo_indicesBibliometricos_v11.md,"## DIMENSION: Investigador ##

Atributos:
• Centro:
Permite clasificar los datos en función del centro al que pertenecen los autores de la publicación.",sentence,151,29,637,788
info_cubo_indicesBibliometricos_v11.md,"• Departamento:
Permite clasificar los datos en función del departamento al que están adscritos los autores de la publicación.",sentence,126,21,790,916
info_cubo_indicesBibliometricos_v11.md,"• Grupo de Investigación:
Permite clasificar los datos en función del grupo de investigación al que pertenecen los autores de la publicación.",sentence,141,24,918,1059
info_cubo_indicesBibliometricos_v11.md,"• Instituto de Investigación:
Permite clasificar los datos en función del instituto universitario de investigación al que pertenecen los autores de la publicación.",sentence,163,25,1061,1224
info_cubo_indicesBibliometricos_v11.md,"• Macroárea:
Permite clasificar los datos en función de la macroárea a la que pertenecen los autores de la publicación.",sentence,119,22,1226,1345
info_cubo_indicesBibliometricos_v11.md,">Valores posibles: Artes y Humanidades, Ciencias, Ciencias Sociales y Jurídicas, Ciencias de la Salud, Ingeniería y
Arquitectura.",sentence,129,24,1347,1476
info_cubo_indicesBibliometricos_v11.md,"• Otros Centros de Investigación:
Permite clasificar los datos en función de si los autores de la publicación pertenecen o no a estructuras de investigación distintas de los institutos universitarios de investigación.",sentence,217,34,1478,1695
info_cubo_indicesBibliometricos_v11.md,>Ejemplo: IIS ‐ Instituto de Investigación Sanitaria de Aragón.,sentence,63,12,1697,1760
info_cubo_indicesBibliometricos_v11.md,"## DIMENSION: Revista ##

Atributos:
• Cuartil:
Clasifica las revistas según el cuartil al que pertenecen, dentro del ranking determinado por los factores de impacto según una materia específica.",sentence,195,36,1762,1957
info_cubo_indicesBibliometricos_v11.md,>Es necesario incorporar a la consulta la dimensión 'AÑO' para mostrar los datos por año de registro.,sentence,101,20,1959,2060
info_cubo_indicesBibliometricos_v11.md,"• Decil:
Clasifica las revistas según el decil al que pertenecen, dentro del ranking determinado por los factores de impacto según una materia específica.",sentence,154,27,2062,2216
info_cubo_indicesBibliometricos_v11.md,>Es necesario incorporar a la consulta la dimensión 'AÑO' para mostrar los datos por año de registro.,sentence,101,20,2218,2319
info_cubo_indicesBibliometricos_v11.md,"• Materia:
Permite clasificar las revistas según la materia a la que pertenecen.",sentence,80,15,2321,2401
info_cubo_matricula_v24.md,"=== MEDIDAS ===

** Alumnos Matriculados **
Número de estudiantes que tienen al menos una asignatura matriculada de un plan de estudios oficial en curso académico, sin tener en cuenta si las asignaturas han sido o no calificadas. Según la dimensión que seleccione, cabe distinguir entre estudiantes matriculados por plan y estudiantes matriculados por asignatura • Matriculados en un plan de estudios: estudiantes cuyo expediente está asociado a un plan de estudios.

>Se incluyen los estudiantes del plan que en virtud de programas de intercambio van a estudiar a ot
universidades españolas o extranjeras.

>No se incluyen los estudiantes que sólo formalizan matrícula con convalidaciones o adaptaciones
reconocimiento de créditos. • Matriculados en una asignatura: estudiantes que, en el curso académico que se seleccione, vayan a obten una calificación en las actas de esa asignatura.

>Se incluyen los estudiantes del plan de la asignatura, estudiantes de otros planes, estudiantes que en virt
de programas de intercambio vienen a la UZ, estudiantes en programas de movilidad de salida y estudian visitantes. Notas: 1. Se contabilizan estudiantes matriculados por plan de estudios. Por tanto, en el total de matriculados cuentan dos veces a los estudiantes matriculados en dos estudios que no formen parte de una programaci conjunta de estudios oficiales de grado o de máster. 2. Los estudiantes que en virtud de programas de intercambio vienen a la UZ a cursar asignaturas de un pl concreto se incluyen en los planes 107 (Movilidad para 1º y 2º ciclo y grado) ó 266 (Movilidad para máste Si no se desea incluir a este tipo de estudiantes, se debe incluir en la consulta la dimensión “Programa Movilidad de Entrada”, filtrándose por el valor ‘N’ (no). 3. No se contabilizan los estudiantes que anulan la matrícula. 4. Si se quiere obtener el número de estudiantes matriculados del plan en asignaturas de ese plan, deb seleccionarse en la consulta las dimensiones ""Plan de Estudio"" y ""Asignatura"", seleccionando en ""Plan estudios"" el que corresponda.

** Créditos Matriculados **
Créditos matriculados por los estudiantes, no anulados, hayan sido calificados o no.

>Nota: no se incluyen créditos de asignaturas que se reconocen, adaptan o convalidan.

** Alumnos en programa de movilidad de Salida **
Estudiantes matriculados que, en virtud de un Programa de Intercambio nacional o internacional, realizan u estancia temporal en otra universidad que conlleva algún tipo de reconocimiento académico.

** Alumnos de Nuevo Ingreso **
Número de estudiantes matriculados en un plan de estudios que consumen alguna de las plazas ofertadas p un año y plan (preinscripción). Se incluyen expedientes SIGMA que han sido abiertos en el curso académico q se seleccione y tienen algún registro en cualquiera de los procedimientos de preinscripción.

>Nota: no se consideran matriculados de nuevo ingreso los que acceden a un estudio por el procedimien
distinto al ordinario de preinscripción: cambio de estudios, traslado de expediente, adaptación al grado, o que anulan la matrícula.

** Ratio Créditos/Alumnos Matriculados **
Cociente entre las medidas ""créditos matriculados"" y ""alumnos matriculados"". Así se obtiene la media de crédit matriculados por los estudiantes.",section,3264,592,0,3264
info_cubo_matricula_v24.md,=== DIMENSIONES ===,section,20,3,3265,3285
info_cubo_matricula_v24.md,"## DIMENSION: Acceso ##

Atributos:
• Estudio previo:
Identifica la clase de estudio cursado anteriormente por los estudiantes, que les da acceso a la Universidad, acuerdo con los requisitos establecidos por la legislación vigente.

>Valores posibles: Pruebas de Acceso, COU sin PAU, FP, Titulados Universitarios, Mayores de 25, Mayores de
Mayores de 45.

>Los estudiantes procedentes de Bachillerato se incluyen en “Pruebas de Acceso”. Los estudiantes proceden
de Ciclos Formativos de Grado Superior se incluyen en “Formación Profesional”, aunque se hayan presenta a la fase específica de la EvAU.

>Nota: el valor “No informado” se aplica a estudiantes procedentes de adaptaciones por extinción de planes
estudios o que no han accedido a la titulación por procedimientos de preinscripción.

• Nuevo Ingreso (S/N):
Indica si los estudiantes son de nuevo ingreso (S) o no (N) en el curso académico que se seleccione. Ver definici de la medida ""Alumnos de Nuevo Ingreso"".",section,971,190,3286,4257
info_cubo_matricula_v24.md,"## DIMENSION: Alumno ##

Atributos:
• País Nacionalidad:
Permite clasificar los datos en función del país de nacionalidad legal de los estudiantes.

• Rango de Edad:
Permite agrupar los rangos de edad de los estudiantes en función de su edad a fecha 31 de diciembre del cur académico en que están matriculados.

>Valores posibles: 18 años o menos, 19, 20, 21, 22, 23, 24, 25, 26, 27, 28, 29, 30 a 34, 35 a 39, 40 a 44, 45 a
50 a 54, 55 a 59, 60 a 64, 65 años o más.

• Residencia Familiar:
Identifica el país, la comunidad autónoma, la provincia o la población de residencia familiar indicada por alumno en el curso académico en que se matricula.

• Sexo:
Permite agrupar los estudiantes en función de su sexo.",section,711,167,4258,4969
info_cubo_matricula_v24.md,"## DIMENSION: Asignatura ##

Notas generales:
- Permite clasificar los datos en función de la asignatura (código y denominación) en que se matriculan estudiantes.

Atributos:
• Clase:
Permite clasificar los datos en función de la clase de asignatura (formación básica, obligatoria, optativa, lib elección, troncal, trabajo fin de grado, trabajo fin de máster, prácticas externas, complementos de formaci actividades académicas complementarias, investigación –en el caso de los doctorados regulados por el 99/2011), tal como viene identificada en el plan de estudios.

• Grupo:
Permite diferenciar los diferentes grupos de matrícula existentes en cada asignatura.

>Nota: se recomienda utilizar esta dimensión junto con la de Asignatura.",section,737,132,4970,5707
info_cubo_matricula_v24.md,"## DIMENSION: CURSO ACADÉMICO ##

Notas generales:
- Identifica los diferentes cursos académicos (por ejemplo 2023/24).",section,120,23,5708,5828
info_cubo_matricula_v24.md,"## DIMENSION: Centro ##

Notas generales:
- Permite clasificar los datos en función del centro (código y denominación) de matrícula de los estudiantes.

Atributos:
• Campus:
Permite clasificar los datos en función del campus en el que se ubica el centro de matrícula de los estudiantes

• Localidad:
Permite clasificar los datos en función de la localidad a la que pertenece el centro de matrícula de los estudiant

• Tipo:
Permite clasificar los datos en función del tipo de centro (facultad, escuela universitaria, centro adscrito, etc.) que se matriculan los estudiantes.",section,575,109,5829,6404
info_cubo_matricula_v24.md,"## DIMENSION: Fecha de actualización ##

Notas generales:
- Indica la fecha de la última recarga de datos. Habitualmente es el domingo anterior a la fecha de consulta datos.",section,174,35,6405,6579
info_cubo_matricula_v24.md,"## DIMENSION: Matrícula ##

Atributos:
• Curso más alto matriculado:
Identifica el máximo curso en el que el alumno tiene asignaturas matriculadas en el curso académico que seleccione.

>Nota: el valor 0 se corresponde con asignaturas de Programas de Doctorado, Proyectos Fin de Carre
asignaturas no asociadas a curso, sino a ciclo, y asignaturas matriculadas por estudiantes de Programas Intercambio que vienen a la UZ.

• Modalidad:
Permite diferenciar los datos en función de la dedicación que el estudiante tenga en la titulación en la que matricula. Esta condición se regula en el Reglamento de permanencia en títulos oficiales adaptados al EEES.

>Valores posibles: tiempo completo, tiempo parcial, otra dedicación (finalizando estudios, con menos del 1
de los créditos del plan por superar).

>En titulaciones anteriores al EEES todos los estudiantes se matriculan a tiempo completo.
>Existe un número mínimo de créditos en que deberán matricularse los estudiantes, en función de ca
modalidad.

• Número de veces:
Determina el número de veces que el alumno ha matriculado una misma asignatura en el curso académico q se seleccione (1 vez, 2 veces, 3 veces, 4 ó más veces).

>Nota: es una dimensión orientada a la asignatura, por lo que se recomienda no combinar esta variable con
plan de estudios si queremos obtener el número de estudiantes matriculados, dado que éstos pueden matricu asignaturas con distinto número de veces en un mismo plan.

• Programa de Movilidad de Entrada (S/N):
Permite filtrar a los estudiantes que proceden de un programa de intercambio nacional o internacional entrada (S) o no (N) en el curso académico que se seleccione.

• Traslado por Continuación de Estudio:
Indica si los estudiantes accedieron al centro en el que están matriculados a través de un traslado (S) o no ( para continuar los mismos estudios iniciados en el centro de origen.",section,1880,355,6580,8460
info_cubo_matricula_v24.md,"## DIMENSION: Titulación ##

Atributos:
• Estudio:
Permite clasificar los datos en función del estudio (código y denominación) en que se matriculan los estudiant Observaciones:

>No es lo mismo “estudio” que “plan de estudios”.
>Bajo un mismo estudio pueden existir varios planes, bien porque se imparten en distintas localidades (ejempl
ADE, Enfermería, Magisterio, Medicina, etc.) o bien porque se ha modificado el plan de estudios, pero el estu sigue siendo el mismo (ejemplos: másteres regulados por el RD 56/2005 que se renuevan en virtud del 1393/2007).

• Grado Experimentalidad:
Permite clasificar los datos en función del grado de experimentalidad en que se encuentren las enseñan conducentes a la obtención de títulos oficiales de grado y máster.

>Nota: se ofrecen datos de experimentalidad desde el curso 2015/16. Desde el curso 2017/18 los estudios
grado tienen 4 posibles grados de experimentalidad.

• Interuniversitario (S/N):
Permite clasificar los estudios o planes de estudio en función de si se imparten de manera conjunta entre var universidades (S) o no (N).

• Interuniversitario coordina Unizar (S/N):
Permite clasificar los estudios o planes de estudio en función de si la Universidad de Zaragoza es la universid coordinadora del estudio universitario (S) o no (N).

• Máster habilitante (S/N):
Permite clasificar los estudios o planes de estudio de Máster en función de si son habilitantes (S) o no (N), acuerdo con lo establecido en el Decreto del Gobierno de Aragón, por el que se fijan los precios públicos por prestación de servicios académicos universitarios, para el curso que corresponda.

>Nota: para tipos de estudio distintos de Máster se muestra “-“.

• Múltiple titulación (S/N):
Permite clasificar los datos en función de si el estudio o plan de estudios se articula a través de un Progra Oficial de Estudios Oficiales de Grado o Máster (S) o no (N).

• Plan de Estudios:
Permite clasificar los datos en función del plan de estudios (código y denominación) en que se matriculan estudiantes.

• Rama de Conocimiento:
Permite clasificar los datos en función de la Rama de Conocimiento (Artes y Humanidades, Ciencias, Cienc Sociales y Jurídicas, Ciencias de la Salud, Ingeniería y Arquitectura) a la que pertenece el estudio en que matriculan los estudiantes.

• Tipo de Estudio:
Permite identificar el tipo de estudio del plan en que se matriculan los estudiantes: grado, máster, doctora movilidad de entrada. Con anterioridad al curso 2016/17 se muestran también licenciatura o equivalen diplomatura o equivalente.",section,2554,493,8461,11015
info_cubo_matricula_v24.md,=== MEDIDAS ===,paragraph,15,3,0,15
info_cubo_matricula_v24.md,"** Alumnos Matriculados **
Número de estudiantes que tienen al menos una asignatura matriculada de un plan de estudios oficial en curso académico, sin tener en cuenta si las asignaturas han sido o no calificadas. Según la dimensión que seleccione, cabe distinguir entre estudiantes matriculados por plan y estudiantes matriculados por asignatura • Matriculados en un plan de estudios: estudiantes cuyo expediente está asociado a un plan de estudios.",paragraph,449,76,17,466
info_cubo_matricula_v24.md,">Se incluyen los estudiantes del plan que en virtud de programas de intercambio van a estudiar a ot
universidades españolas o extranjeras.",paragraph,138,24,468,606
info_cubo_matricula_v24.md,">No se incluyen los estudiantes que sólo formalizan matrícula con convalidaciones o adaptaciones
reconocimiento de créditos. • Matriculados en una asignatura: estudiantes que, en el curso académico que se seleccione, vayan a obten una calificación en las actas de esa asignatura.",paragraph,279,47,608,887
info_cubo_matricula_v24.md,">Se incluyen los estudiantes del plan de la asignatura, estudiantes de otros planes, estudiantes que en virt
de programas de intercambio vienen a la UZ, estudiantes en programas de movilidad de salida y estudian visitantes. Notas: 1. Se contabilizan estudiantes matriculados por plan de estudios. Por tanto, en el total de matriculados cuentan dos veces a los estudiantes matriculados en dos estudios que no formen parte de una programaci conjunta de estudios oficiales de grado o de máster. 2. Los estudiantes que en virtud de programas de intercambio vienen a la UZ a cursar asignaturas de un pl concreto se incluyen en los planes 107 (Movilidad para 1º y 2º ciclo y grado) ó 266 (Movilidad para máste Si no se desea incluir a este tipo de estudiantes, se debe incluir en la consulta la dimensión “Programa Movilidad de Entrada”, filtrándose por el valor ‘N’ (no). 3. No se contabilizan los estudiantes que anulan la matrícula. 4. Si se quiere obtener el número de estudiantes matriculados del plan en asignaturas de ese plan, deb seleccionarse en la consulta las dimensiones ""Plan de Estudio"" y ""Asignatura"", seleccionando en ""Plan estudios"" el que corresponda.",paragraph,1164,227,889,2053
info_cubo_matricula_v24.md,"** Créditos Matriculados **
Créditos matriculados por los estudiantes, no anulados, hayan sido calificados o no.",paragraph,112,21,2055,2167
info_cubo_matricula_v24.md,">Nota: no se incluyen créditos de asignaturas que se reconocen, adaptan o convalidan.",paragraph,85,17,2169,2254
info_cubo_matricula_v24.md,"** Alumnos en programa de movilidad de Salida **
Estudiantes matriculados que, en virtud de un Programa de Intercambio nacional o internacional, realizan u estancia temporal en otra universidad que conlleva algún tipo de reconocimiento académico.",paragraph,246,41,2256,2502
info_cubo_matricula_v24.md,"** Alumnos de Nuevo Ingreso **
Número de estudiantes matriculados en un plan de estudios que consumen alguna de las plazas ofertadas p un año y plan (preinscripción). Se incluyen expedientes SIGMA que han sido abiertos en el curso académico q se seleccione y tienen algún registro en cualquiera de los procedimientos de preinscripción.",paragraph,335,60,2504,2839
info_cubo_matricula_v24.md,">Nota: no se consideran matriculados de nuevo ingreso los que acceden a un estudio por el procedimien
distinto al ordinario de preinscripción: cambio de estudios, traslado de expediente, adaptación al grado, o que anulan la matrícula.",paragraph,234,43,2841,3075
info_cubo_matricula_v24.md,"** Ratio Créditos/Alumnos Matriculados **
Cociente entre las medidas ""créditos matriculados"" y ""alumnos matriculados"". Así se obtiene la media de crédit matriculados por los estudiantes.",paragraph,186,33,3077,3263
info_cubo_matricula_v24.md,=== DIMENSIONES ===,paragraph,19,3,3265,3284
info_cubo_matricula_v24.md,## DIMENSION: Acceso ##,paragraph,23,7,3286,3309
info_cubo_matricula_v24.md,"Atributos:
• Estudio previo:
Identifica la clase de estudio cursado anteriormente por los estudiantes, que les da acceso a la Universidad, acuerdo con los requisitos establecidos por la legislación vigente.",paragraph,206,35,3311,3517
info_cubo_matricula_v24.md,">Valores posibles: Pruebas de Acceso, COU sin PAU, FP, Titulados Universitarios, Mayores de 25, Mayores de
Mayores de 45.",paragraph,121,27,3519,3640
info_cubo_matricula_v24.md,">Los estudiantes procedentes de Bachillerato se incluyen en “Pruebas de Acceso”. Los estudiantes proceden
de Ciclos Formativos de Grado Superior se incluyen en “Formación Profesional”, aunque se hayan presenta a la fase específica de la EvAU.",paragraph,242,44,3642,3884
info_cubo_matricula_v24.md,">Nota: el valor “No informado” se aplica a estudiantes procedentes de adaptaciones por extinción de planes
estudios o que no han accedido a la titulación por procedimientos de preinscripción.",paragraph,191,34,3886,4077
info_cubo_matricula_v24.md,"• Nuevo Ingreso (S/N):
Indica si los estudiantes son de nuevo ingreso (S) o no (N) en el curso académico que se seleccione. Ver definici de la medida ""Alumnos de Nuevo Ingreso"".",paragraph,177,43,4079,4256
info_cubo_matricula_v24.md,## DIMENSION: Alumno ##,paragraph,23,7,4258,4281
info_cubo_matricula_v24.md,"Atributos:
• País Nacionalidad:
Permite clasificar los datos en función del país de nacionalidad legal de los estudiantes.",paragraph,122,21,4283,4405
info_cubo_matricula_v24.md,"• Rango de Edad:
Permite agrupar los rangos de edad de los estudiantes en función de su edad a fecha 31 de diciembre del cur académico en que están matriculados.",paragraph,161,32,4407,4568
info_cubo_matricula_v24.md,">Valores posibles: 18 años o menos, 19, 20, 21, 22, 23, 24, 25, 26, 27, 28, 29, 30 a 34, 35 a 39, 40 a 44, 45 a
50 a 54, 55 a 59, 60 a 64, 65 años o más.",paragraph,153,62,4570,4723
info_cubo_matricula_v24.md,"• Residencia Familiar:
Identifica el país, la comunidad autónoma, la provincia o la población de residencia familiar indicada por alumno en el curso académico en que se matricula.",paragraph,179,32,4725,4904
info_cubo_matricula_v24.md,"• Sexo:
Permite agrupar los estudiantes en función de su sexo.",paragraph,62,13,4906,4968
info_cubo_matricula_v24.md,## DIMENSION: Asignatura ##,paragraph,27,7,4970,4997
info_cubo_matricula_v24.md,"Notas generales:
- Permite clasificar los datos en función de la asignatura (código y denominación) en que se matriculan estudiantes.",paragraph,133,24,4999,5132
info_cubo_matricula_v24.md,"Atributos:
• Clase:
Permite clasificar los datos en función de la clase de asignatura (formación básica, obligatoria, optativa, lib elección, troncal, trabajo fin de grado, trabajo fin de máster, prácticas externas, complementos de formaci actividades académicas complementarias, investigación –en el caso de los doctorados regulados por el 99/2011), tal como viene identificada en el plan de estudios.",paragraph,402,72,5134,5536
info_cubo_matricula_v24.md,"• Grupo:
Permite diferenciar los diferentes grupos de matrícula existentes en cada asignatura.",paragraph,94,15,5538,5632
info_cubo_matricula_v24.md,>Nota: se recomienda utilizar esta dimensión junto con la de Asignatura.,paragraph,72,14,5634,5706
info_cubo_matricula_v24.md,## DIMENSION: CURSO ACADÉMICO ##,paragraph,32,8,5708,5740
info_cubo_matricula_v24.md,"Notas generales:
- Identifica los diferentes cursos académicos (por ejemplo 2023/24).",paragraph,85,15,5742,5827
info_cubo_matricula_v24.md,## DIMENSION: Centro ##,paragraph,23,7,5829,5852
info_cubo_matricula_v24.md,"Notas generales:
- Permite clasificar los datos en función del centro (código y denominación) de matrícula de los estudiantes.",paragraph,126,23,5854,5980
info_cubo_matricula_v24.md,"Atributos:
• Campus:
Permite clasificar los datos en función del campus en el que se ubica el centro de matrícula de los estudiantes",paragraph,132,25,5982,6114
info_cubo_matricula_v24.md,"• Localidad:
Permite clasificar los datos en función de la localidad a la que pertenece el centro de matrícula de los estudiant",paragraph,127,23,6116,6243
info_cubo_matricula_v24.md,"• Tipo:
Permite clasificar los datos en función del tipo de centro (facultad, escuela universitaria, centro adscrito, etc.) que se matriculan los estudiantes.",paragraph,158,31,6245,6403
info_cubo_matricula_v24.md,## DIMENSION: Fecha de actualización ##,paragraph,39,9,6405,6444
info_cubo_matricula_v24.md,"Notas generales:
- Indica la fecha de la última recarga de datos. Habitualmente es el domingo anterior a la fecha de consulta datos.",paragraph,132,26,6446,6578
info_cubo_matricula_v24.md,## DIMENSION: Matrícula ##,paragraph,26,7,6580,6606
info_cubo_matricula_v24.md,"Atributos:
• Curso más alto matriculado:
Identifica el máximo curso en el que el alumno tiene asignaturas matriculadas en el curso académico que seleccione.",paragraph,156,27,6608,6764
info_cubo_matricula_v24.md,">Nota: el valor 0 se corresponde con asignaturas de Programas de Doctorado, Proyectos Fin de Carre
asignaturas no asociadas a curso, sino a ciclo, y asignaturas matriculadas por estudiantes de Programas Intercambio que vienen a la UZ.",paragraph,234,43,6766,7000
info_cubo_matricula_v24.md,"• Modalidad:
Permite diferenciar los datos en función de la dedicación que el estudiante tenga en la titulación en la que matricula. Esta condición se regula en el Reglamento de permanencia en títulos oficiales adaptados al EEES.",paragraph,229,40,7002,7231
info_cubo_matricula_v24.md,">Valores posibles: tiempo completo, tiempo parcial, otra dedicación (finalizando estudios, con menos del 1
de los créditos del plan por superar).",paragraph,145,29,7233,7378
info_cubo_matricula_v24.md,">En titulaciones anteriores al EEES todos los estudiantes se matriculan a tiempo completo.
>Existe un número mínimo de créditos en que deberán matricularse los estudiantes, en función de ca
modalidad.",paragraph,200,35,7380,7580
info_cubo_matricula_v24.md,"• Número de veces:
Determina el número de veces que el alumno ha matriculado una misma asignatura en el curso académico q se seleccione (1 vez, 2 veces, 3 veces, 4 ó más veces).",paragraph,177,41,7582,7759
info_cubo_matricula_v24.md,">Nota: es una dimensión orientada a la asignatura, por lo que se recomienda no combinar esta variable con
plan de estudios si queremos obtener el número de estudiantes matriculados, dado que éstos pueden matricu asignaturas con distinto número de veces en un mismo plan.",paragraph,270,49,7761,8031
info_cubo_matricula_v24.md,"• Programa de Movilidad de Entrada (S/N):
Permite filtrar a los estudiantes que proceden de un programa de intercambio nacional o internacional entrada (S) o no (N) en el curso académico que se seleccione.",paragraph,205,42,8033,8238
info_cubo_matricula_v24.md,"• Traslado por Continuación de Estudio:
Indica si los estudiantes accedieron al centro en el que están matriculados a través de un traslado (S) o no ( para continuar los mismos estudios iniciados en el centro de origen.",paragraph,219,42,8240,8459
info_cubo_matricula_v24.md,## DIMENSION: Titulación ##,paragraph,27,7,8461,8488
info_cubo_matricula_v24.md,"Atributos:
• Estudio:
Permite clasificar los datos en función del estudio (código y denominación) en que se matriculan los estudiant Observaciones:",paragraph,147,26,8490,8637
info_cubo_matricula_v24.md,">No es lo mismo “estudio” que “plan de estudios”.
>Bajo un mismo estudio pueden existir varios planes, bien porque se imparten en distintas localidades (ejempl
ADE, Enfermería, Magisterio, Medicina, etc.) o bien porque se ha modificado el plan de estudios, pero el estu sigue siendo el mismo (ejemplos: másteres regulados por el RD 56/2005 que se renuevan en virtud del 1393/2007).",paragraph,381,81,8639,9020
info_cubo_matricula_v24.md,"• Grado Experimentalidad:
Permite clasificar los datos en función del grado de experimentalidad en que se encuentren las enseñan conducentes a la obtención de títulos oficiales de grado y máster.",paragraph,195,32,9022,9217
info_cubo_matricula_v24.md,">Nota: se ofrecen datos de experimentalidad desde el curso 2015/16. Desde el curso 2017/18 los estudios
grado tienen 4 posibles grados de experimentalidad.",paragraph,155,27,9219,9374
info_cubo_matricula_v24.md,"• Interuniversitario (S/N):
Permite clasificar los estudios o planes de estudio en función de si se imparten de manera conjunta entre var universidades (S) o no (N).",paragraph,165,35,9376,9541
info_cubo_matricula_v24.md,"• Interuniversitario coordina Unizar (S/N):
Permite clasificar los estudios o planes de estudio en función de si la Universidad de Zaragoza es la universid coordinadora del estudio universitario (S) o no (N).",paragraph,208,40,9543,9751
info_cubo_matricula_v24.md,"• Máster habilitante (S/N):
Permite clasificar los estudios o planes de estudio de Máster en función de si son habilitantes (S) o no (N), acuerdo con lo establecido en el Decreto del Gobierno de Aragón, por el que se fijan los precios públicos por prestación de servicios académicos universitarios, para el curso que corresponda.",paragraph,329,65,9753,10082
info_cubo_matricula_v24.md,>Nota: para tipos de estudio distintos de Máster se muestra “-“.,paragraph,64,16,10084,10148
info_cubo_matricula_v24.md,"• Múltiple titulación (S/N):
Permite clasificar los datos en función de si el estudio o plan de estudios se articula a través de un Progra Oficial de Estudios Oficiales de Grado o Máster (S) o no (N).",paragraph,200,45,10150,10350
info_cubo_matricula_v24.md,"• Plan de Estudios:
Permite clasificar los datos en función del plan de estudios (código y denominación) en que se matriculan estudiantes.",paragraph,138,26,10352,10490
info_cubo_matricula_v24.md,"• Rama de Conocimiento:
Permite clasificar los datos en función de la Rama de Conocimiento (Artes y Humanidades, Ciencias, Cienc Sociales y Jurídicas, Ciencias de la Salud, Ingeniería y Arquitectura) a la que pertenece el estudio en que matriculan los estudiantes.",paragraph,264,49,10492,10756
info_cubo_matricula_v24.md,"• Tipo de Estudio:
Permite identificar el tipo de estudio del plan en que se matriculan los estudiantes: grado, máster, doctora movilidad de entrada. Con anterioridad al curso 2016/17 se muestran también licenciatura o equivalen diplomatura o equivalente.",paragraph,255,44,10758,11013
info_cubo_matricula_v24.md,"=== MEDIDAS ===

** Alumnos Matriculados **
Número de estudiantes que tienen al menos una asignatura matriculada de un plan de estudios oficial en curso académico, sin tener en cuenta si las asignaturas han sido o no calificadas.",sentence,229,42,0,229
info_cubo_matricula_v24.md,"Según la dimensión que seleccione, cabe distinguir entre estudiantes matriculados por plan y estudiantes matriculados por asignatura • Matriculados en un plan de estudios: estudiantes cuyo expediente está asociado a un plan de estudios.",sentence,236,37,229,465
info_cubo_matricula_v24.md,">Se incluyen los estudiantes del plan que en virtud de programas de intercambio van a estudiar a ot
universidades españolas o extranjeras.",sentence,138,24,466,604
info_cubo_matricula_v24.md,">No se incluyen los estudiantes que sólo formalizan matrícula con convalidaciones o adaptaciones
reconocimiento de créditos.",sentence,124,18,606,730
info_cubo_matricula_v24.md,"• Matriculados en una asignatura: estudiantes que, en el curso académico que se seleccione, vayan a obten una calificación en las actas de esa asignatura.",sentence,154,29,732,886
info_cubo_matricula_v24.md,">Se incluyen los estudiantes del plan de la asignatura, estudiantes de otros planes, estudiantes que en virt
de programas de intercambio vienen a la UZ, estudiantes en programas de movilidad de salida y estudian visitantes.",sentence,223,40,887,1110
info_cubo_matricula_v24.md,Notas: 1.,sentence,9,4,1112,1121
info_cubo_matricula_v24.md,Se contabilizan estudiantes matriculados por plan de estudios.,sentence,62,9,1122,1184
info_cubo_matricula_v24.md,"Por tanto, en el total de matriculados cuentan dos veces a los estudiantes matriculados en dos estudios que no formen parte de una programaci conjunta de estudios oficiales de grado o de máster.",sentence,194,35,1185,1379
info_cubo_matricula_v24.md,2.,sentence,2,2,1380,1382
info_cubo_matricula_v24.md,"Los estudiantes que en virtud de programas de intercambio vienen a la UZ a cursar asignaturas de un pl concreto se incluyen en los planes 107 (Movilidad para 1º y 2º ciclo y grado) ó 266 (Movilidad para máste Si no se desea incluir a este tipo de estudiantes, se debe incluir en la consulta la dimensión “Programa Movilidad de Entrada”, filtrándose por el valor ‘N’ (no).",sentence,371,79,1383,1754
info_cubo_matricula_v24.md,3.,sentence,2,2,1755,1757
info_cubo_matricula_v24.md,No se contabilizan los estudiantes que anulan la matrícula.,sentence,59,10,1758,1817
info_cubo_matricula_v24.md,4.,sentence,2,2,1818,1820
info_cubo_matricula_v24.md,"Si se quiere obtener el número de estudiantes matriculados del plan en asignaturas de ese plan, deb seleccionarse en la consulta las dimensiones ""Plan de Estudio"" y ""Asignatura"", seleccionando en ""Plan estudios"" el que corresponda.",sentence,231,44,1821,2052
info_cubo_matricula_v24.md,"** Créditos Matriculados **
Créditos matriculados por los estudiantes, no anulados, hayan sido calificados o no.",sentence,112,21,2053,2165
info_cubo_matricula_v24.md,">Nota: no se incluyen créditos de asignaturas que se reconocen, adaptan o convalidan.",sentence,85,17,2167,2252
info_cubo_matricula_v24.md,"** Alumnos en programa de movilidad de Salida **
Estudiantes matriculados que, en virtud de un Programa de Intercambio nacional o internacional, realizan u estancia temporal en otra universidad que conlleva algún tipo de reconocimiento académico.",sentence,246,41,2254,2500
info_cubo_matricula_v24.md,"** Alumnos de Nuevo Ingreso **
Número de estudiantes matriculados en un plan de estudios que consumen alguna de las plazas ofertadas p un año y plan (preinscripción).",sentence,166,33,2502,2668
info_cubo_matricula_v24.md,Se incluyen expedientes SIGMA que han sido abiertos en el curso académico q se seleccione y tienen algún registro en cualquiera de los procedimientos de preinscripción.,sentence,168,27,2670,2838
info_cubo_matricula_v24.md,">Nota: no se consideran matriculados de nuevo ingreso los que acceden a un estudio por el procedimien
distinto al ordinario de preinscripción: cambio de estudios, traslado de expediente, adaptación al grado, o que anulan la matrícula.",sentence,234,43,2839,3073
info_cubo_matricula_v24.md,"** Ratio Créditos/Alumnos Matriculados **
Cociente entre las medidas ""créditos matriculados"" y ""alumnos matriculados"".",sentence,118,21,3075,3193
info_cubo_matricula_v24.md,Así se obtiene la media de crédit matriculados por los estudiantes.,sentence,67,12,3195,3262
info_cubo_matricula_v24.md,"=== DIMENSIONES ===

## DIMENSION: Acceso ##

Atributos:
• Estudio previo:
Identifica la clase de estudio cursado anteriormente por los estudiantes, que les da acceso a la Universidad, acuerdo con los requisitos establecidos por la legislación vigente.",sentence,252,45,3263,3515
info_cubo_matricula_v24.md,">Valores posibles: Pruebas de Acceso, COU sin PAU, FP, Titulados Universitarios, Mayores de 25, Mayores de
Mayores de 45.",sentence,121,27,3517,3638
info_cubo_matricula_v24.md,>Los estudiantes procedentes de Bachillerato se incluyen en “Pruebas de Acceso”.,sentence,80,15,3640,3720
info_cubo_matricula_v24.md,"Los estudiantes proceden
de Ciclos Formativos de Grado Superior se incluyen en “Formación Profesional”, aunque se hayan presenta a la fase específica de la EvAU.",sentence,161,29,3722,3883
info_cubo_matricula_v24.md,">Nota: el valor “No informado” se aplica a estudiantes procedentes de adaptaciones por extinción de planes
estudios o que no han accedido a la titulación por procedimientos de preinscripción.",sentence,191,34,3884,4075
info_cubo_matricula_v24.md,"• Nuevo Ingreso (S/N):
Indica si los estudiantes son de nuevo ingreso (S) o no (N) en el curso académico que se seleccione.",sentence,123,31,4077,4200
info_cubo_matricula_v24.md,"Ver definici de la medida ""Alumnos de Nuevo Ingreso"".",sentence,53,12,4202,4255
info_cubo_matricula_v24.md,"## DIMENSION: Alumno ##

Atributos:
• País Nacionalidad:
Permite clasificar los datos en función del país de nacionalidad legal de los estudiantes.",sentence,147,28,4256,4403
info_cubo_matricula_v24.md,"• Rango de Edad:
Permite agrupar los rangos de edad de los estudiantes en función de su edad a fecha 31 de diciembre del cur académico en que están matriculados.",sentence,161,32,4405,4566
info_cubo_matricula_v24.md,">Valores posibles: 18 años o menos, 19, 20, 21, 22, 23, 24, 25, 26, 27, 28, 29, 30 a 34, 35 a 39, 40 a 44, 45 a
50 a 54, 55 a 59, 60 a 64, 65 años o más.",sentence,153,62,4568,4721
info_cubo_matricula_v24.md,"• Residencia Familiar:
Identifica el país, la comunidad autónoma, la provincia o la población de residencia familiar indicada por alumno en el curso académico en que se matricula.",sentence,179,32,4723,4902
info_cubo_matricula_v24.md,"• Sexo:
Permite agrupar los estudiantes en función de su sexo.",sentence,62,13,4904,4966
info_cubo_matricula_v24.md,"## DIMENSION: Asignatura ##

Notas generales:
- Permite clasificar los datos en función de la asignatura (código y denominación) en que se matriculan estudiantes.",sentence,162,31,4968,5130
info_cubo_matricula_v24.md,"Atributos:
• Clase:
Permite clasificar los datos en función de la clase de asignatura (formación básica, obligatoria, optativa, lib elección, troncal, trabajo fin de grado, trabajo fin de máster, prácticas externas, complementos de formaci actividades académicas complementarias, investigación –en el caso de los doctorados regulados por el 99/2011), tal como viene identificada en el plan de estudios.",sentence,402,72,5132,5534
info_cubo_matricula_v24.md,"• Grupo:
Permite diferenciar los diferentes grupos de matrícula existentes en cada asignatura.",sentence,94,15,5536,5630
info_cubo_matricula_v24.md,>Nota: se recomienda utilizar esta dimensión junto con la de Asignatura.,sentence,72,14,5632,5704
info_cubo_matricula_v24.md,"## DIMENSION: CURSO ACADÉMICO ##

Notas generales:
- Identifica los diferentes cursos académicos (por ejemplo 2023/24).",sentence,119,23,5706,5825
info_cubo_matricula_v24.md,"## DIMENSION: Centro ##

Notas generales:
- Permite clasificar los datos en función del centro (código y denominación) de matrícula de los estudiantes.",sentence,151,30,5827,5978
info_cubo_matricula_v24.md,"Atributos:
• Campus:
Permite clasificar los datos en función del campus en el que se ubica el centro de matrícula de los estudiantes

• Localidad:
Permite clasificar los datos en función de la localidad a la que pertenece el centro de matrícula de los estudiant

• Tipo:
Permite clasificar los datos en función del tipo de centro (facultad, escuela universitaria, centro adscrito, etc.)",sentence,386,73,5980,6366
info_cubo_matricula_v24.md,que se matriculan los estudiantes.,sentence,34,6,6368,6402
info_cubo_matricula_v24.md,"## DIMENSION: Fecha de actualización ##

Notas generales:
- Indica la fecha de la última recarga de datos.",sentence,106,23,6403,6509
info_cubo_matricula_v24.md,Habitualmente es el domingo anterior a la fecha de consulta datos.,sentence,66,12,6511,6577
info_cubo_matricula_v24.md,"## DIMENSION: Matrícula ##

Atributos:
• Curso más alto matriculado:
Identifica el máximo curso en el que el alumno tiene asignaturas matriculadas en el curso académico que seleccione.",sentence,184,34,6578,6762
info_cubo_matricula_v24.md,">Nota: el valor 0 se corresponde con asignaturas de Programas de Doctorado, Proyectos Fin de Carre
asignaturas no asociadas a curso, sino a ciclo, y asignaturas matriculadas por estudiantes de Programas Intercambio que vienen a la UZ.",sentence,234,43,6764,6998
info_cubo_matricula_v24.md,"• Modalidad:
Permite diferenciar los datos en función de la dedicación que el estudiante tenga en la titulación en la que matricula.",sentence,132,24,7000,7132
info_cubo_matricula_v24.md,Esta condición se regula en el Reglamento de permanencia en títulos oficiales adaptados al EEES.,sentence,96,16,7134,7230
info_cubo_matricula_v24.md,">Valores posibles: tiempo completo, tiempo parcial, otra dedicación (finalizando estudios, con menos del 1
de los créditos del plan por superar).",sentence,145,29,7231,7376
info_cubo_matricula_v24.md,>En titulaciones anteriores al EEES todos los estudiantes se matriculan a tiempo completo.,sentence,90,15,7378,7468
info_cubo_matricula_v24.md,">Existe un número mínimo de créditos en que deberán matricularse los estudiantes, en función de ca
modalidad.",sentence,109,20,7470,7579
info_cubo_matricula_v24.md,"• Número de veces:
Determina el número de veces que el alumno ha matriculado una misma asignatura en el curso académico q se seleccione (1 vez, 2 veces, 3 veces, 4 ó más veces).",sentence,177,41,7580,7757
info_cubo_matricula_v24.md,">Nota: es una dimensión orientada a la asignatura, por lo que se recomienda no combinar esta variable con
plan de estudios si queremos obtener el número de estudiantes matriculados, dado que éstos pueden matricu asignaturas con distinto número de veces en un mismo plan.",sentence,270,49,7759,8029
info_cubo_matricula_v24.md,"• Programa de Movilidad de Entrada (S/N):
Permite filtrar a los estudiantes que proceden de un programa de intercambio nacional o internacional entrada (S) o no (N) en el curso académico que se seleccione.",sentence,205,42,8031,8236
info_cubo_matricula_v24.md,"• Traslado por Continuación de Estudio:
Indica si los estudiantes accedieron al centro en el que están matriculados a través de un traslado (S) o no ( para continuar los mismos estudios iniciados en el centro de origen.",sentence,219,42,8238,8457
info_cubo_matricula_v24.md,"## DIMENSION: Titulación ##

Atributos:
• Estudio:
Permite clasificar los datos en función del estudio (código y denominación) en que se matriculan los estudiant Observaciones:

>No es lo mismo “estudio” que “plan de estudios”.",sentence,227,48,8459,8686
info_cubo_matricula_v24.md,">Bajo un mismo estudio pueden existir varios planes, bien porque se imparten en distintas localidades (ejempl
ADE, Enfermería, Magisterio, Medicina, etc.)",sentence,154,30,8688,8842
info_cubo_matricula_v24.md,"o bien porque se ha modificado el plan de estudios, pero el estu sigue siendo el mismo (ejemplos: másteres regulados por el RD 56/2005 que se renuevan en virtud del 1393/2007).",sentence,176,36,8843,9019
info_cubo_matricula_v24.md,"• Grado Experimentalidad:
Permite clasificar los datos en función del grado de experimentalidad en que se encuentren las enseñan conducentes a la obtención de títulos oficiales de grado y máster.",sentence,195,32,9020,9215
info_cubo_matricula_v24.md,>Nota: se ofrecen datos de experimentalidad desde el curso 2015/16.,sentence,67,13,9217,9284
info_cubo_matricula_v24.md,"Desde el curso 2017/18 los estudios
grado tienen 4 posibles grados de experimentalidad.",sentence,87,14,9286,9373
info_cubo_matricula_v24.md,"• Interuniversitario (S/N):
Permite clasificar los estudios o planes de estudio en función de si se imparten de manera conjunta entre var universidades (S) o no (N).",sentence,165,35,9374,9539
info_cubo_matricula_v24.md,"• Interuniversitario coordina Unizar (S/N):
Permite clasificar los estudios o planes de estudio en función de si la Universidad de Zaragoza es la universid coordinadora del estudio universitario (S) o no (N).",sentence,208,40,9541,9749
info_cubo_matricula_v24.md,"• Máster habilitante (S/N):
Permite clasificar los estudios o planes de estudio de Máster en función de si son habilitantes (S) o no (N), acuerdo con lo establecido en el Decreto del Gobierno de Aragón, por el que se fijan los precios públicos por prestación de servicios académicos universitarios, para el curso que corresponda.",sentence,329,65,9751,10080
info_cubo_matricula_v24.md,>Nota: para tipos de estudio distintos de Máster se muestra “-“.,sentence,64,16,10082,10146
info_cubo_matricula_v24.md,"• Múltiple titulación (S/N):
Permite clasificar los datos en función de si el estudio o plan de estudios se articula a través de un Progra Oficial de Estudios Oficiales de Grado o Máster (S) o no (N).",sentence,200,45,10148,10348
info_cubo_matricula_v24.md,"• Plan de Estudios:
Permite clasificar los datos en función del plan de estudios (código y denominación) en que se matriculan estudiantes.",sentence,138,26,10350,10488
info_cubo_matricula_v24.md,"• Rama de Conocimiento:
Permite clasificar los datos en función de la Rama de Conocimiento (Artes y Humanidades, Ciencias, Cienc Sociales y Jurídicas, Ciencias de la Salud, Ingeniería y Arquitectura) a la que pertenece el estudio en que matriculan los estudiantes.",sentence,264,49,10490,10754
info_cubo_matricula_v24.md,"• Tipo de Estudio:
Permite identificar el tipo de estudio del plan en que se matriculan los estudiantes: grado, máster, doctora movilidad de entrada.",sentence,149,29,10756,10905
info_cubo_matricula_v24.md,Con anterioridad al curso 2016/17 se muestran también licenciatura o equivalen diplomatura o equivalente.,sentence,105,15,10907,11012
info_cubo_matriEEPP_v11.md,"=== MEDIDAS ===

** Alumnos Matriculados **
Número total de estudiantes matriculados en Estudios Propios.

>Se debe introducir en la consulta la dimensión “CURSO ACADÉMICO”. De esta forma se evita acumular el to
de estudiantes de todos los cursos.",section,248,47,0,248
info_cubo_matriEEPP_v11.md,=== DIMENSIONES ===,section,20,3,249,269
info_cubo_matriEEPP_v11.md,"## DIMENSION: Alumno ##

Atributos:
• País Nacionalidad:
Permite clasificar los datos en función del país de nacionalidad legal de los estudiantes.

• País Procedencia:
Identifica el país de residencia familiar indicado por el estudiante en SIGMA.

• Rango de Edad:
Permite agrupar los rangos de edad de los estudiantes en función de su edad a fecha 31 de diciembre del cur académico en que están matriculados.

>Valores posibles: 18 años o menos, 19, 20, 21, 22, 23, 24, 25, 26, 27, 28, 29, 30 a 34, 35 a 39, 40 a 44, 45 a 4
50 a 54, 55 a 59, 60 a 64, 65 años o más.

• Sexo:
Permite agrupar los estudiantes en función de su sexo.",section,632,153,270,902
info_cubo_matriEEPP_v11.md,"## DIMENSION: CURSO ACADÉMICO ##

Notas generales:
- Identifica los diferentes cursos académicos (por ejemplo 2013/14) de matrícula de los estudiantes.",section,152,28,903,1055
info_cubo_matriEEPP_v11.md,"## DIMENSION: Estudio Propio ##

Atributos:
• Duración (cursos):
Permite clasificar los datos en función del número de cursos de que consta el estudio.

• Edición:
Permite clasificar los datos en función del número de edición de los cursos desde su implantación.

• Modalidad:
Permite clasificar los datos en función de la presencialidad del estudio.

>Valores posibles: Presencial, Semipresencial, Semipresencial/On-line, Presencial/Semipresencial/On-line,
Presencial/Semipresencial, Presencial / On line, On line.

• Nombre:
Permite clasificar los datos en función del estudio (código y denominación) en que se matriculan los estudiantes.

• Rama:
Permite clasificar los datos en función de la Rama de Conocimiento (Artes y Humanidades, Ciencias, Ciencias Sociales y Jurídicas, Ciencias de la Salud, Ingeniería y Arquitectura) a la que pertenece el estudio en que se matriculan los estudiantes.

• Tipo:
Permite clasificar los datos en función de la tipología recogida en el marco del Reglamento de Formación Permanente.

>Valores posibles: Máster Propio, Experto Universitario, Diploma de Especialización, Certificación de Extensi
Universitaria, Diploma de Extensión Universitaria.

• Órgano Gestión:
Permite clasificar los datos en función del centro encargado de la gestión administrativa de las enseñanzas.

• Órgano Proponente:
Permite clasificar los datos en función del centro responsable de la impartición de las enseñanzas.",section,1435,247,1056,2491
info_cubo_matriEEPP_v11.md,"## DIMENSION: Fecha de actualización ##

Notas generales:
- Indica la fecha de la última recarga de datos. Habitualmente es el domingo anterior a la consulta de datos.",section,169,34,2492,2661
info_cubo_matriEEPP_v11.md,=== MEDIDAS ===,paragraph,15,3,0,15
info_cubo_matriEEPP_v11.md,"** Alumnos Matriculados **
Número total de estudiantes matriculados en Estudios Propios.",paragraph,88,15,17,105
info_cubo_matriEEPP_v11.md,">Se debe introducir en la consulta la dimensión “CURSO ACADÉMICO”. De esta forma se evita acumular el to
de estudiantes de todos los cursos.",paragraph,140,29,107,247
info_cubo_matriEEPP_v11.md,=== DIMENSIONES ===,paragraph,19,3,249,268
info_cubo_matriEEPP_v11.md,## DIMENSION: Alumno ##,paragraph,23,7,270,293
info_cubo_matriEEPP_v11.md,"Atributos:
• País Nacionalidad:
Permite clasificar los datos en función del país de nacionalidad legal de los estudiantes.",paragraph,122,21,295,417
info_cubo_matriEEPP_v11.md,"• País Procedencia:
Identifica el país de residencia familiar indicado por el estudiante en SIGMA.",paragraph,98,17,419,517
info_cubo_matriEEPP_v11.md,"• Rango de Edad:
Permite agrupar los rangos de edad de los estudiantes en función de su edad a fecha 31 de diciembre del cur académico en que están matriculados.",paragraph,161,32,519,680
info_cubo_matriEEPP_v11.md,">Valores posibles: 18 años o menos, 19, 20, 21, 22, 23, 24, 25, 26, 27, 28, 29, 30 a 34, 35 a 39, 40 a 44, 45 a 4
50 a 54, 55 a 59, 60 a 64, 65 años o más.",paragraph,155,63,682,837
info_cubo_matriEEPP_v11.md,"• Sexo:
Permite agrupar los estudiantes en función de su sexo.",paragraph,62,13,839,901
info_cubo_matriEEPP_v11.md,## DIMENSION: CURSO ACADÉMICO ##,paragraph,32,8,903,935
info_cubo_matriEEPP_v11.md,"Notas generales:
- Identifica los diferentes cursos académicos (por ejemplo 2013/14) de matrícula de los estudiantes.",paragraph,117,20,937,1054
info_cubo_matriEEPP_v11.md,## DIMENSION: Estudio Propio ##,paragraph,31,8,1056,1087
info_cubo_matriEEPP_v11.md,"Atributos:
• Duración (cursos):
Permite clasificar los datos en función del número de cursos de que consta el estudio.",paragraph,118,24,1089,1207
info_cubo_matriEEPP_v11.md,"• Edición:
Permite clasificar los datos en función del número de edición de los cursos desde su implantación.",paragraph,109,20,1209,1318
info_cubo_matriEEPP_v11.md,"• Modalidad:
Permite clasificar los datos en función de la presencialidad del estudio.",paragraph,86,15,1320,1406
info_cubo_matriEEPP_v11.md,">Valores posibles: Presencial, Semipresencial, Semipresencial/On-line, Presencial/Semipresencial/On-line,
Presencial/Semipresencial, Presencial / On line, On line.",paragraph,163,22,1408,1571
info_cubo_matriEEPP_v11.md,"• Nombre:
Permite clasificar los datos en función del estudio (código y denominación) en que se matriculan los estudiantes.",paragraph,123,23,1573,1696
info_cubo_matriEEPP_v11.md,"• Rama:
Permite clasificar los datos en función de la Rama de Conocimiento (Artes y Humanidades, Ciencias, Ciencias Sociales y Jurídicas, Ciencias de la Salud, Ingeniería y Arquitectura) a la que pertenece el estudio en que se matriculan los estudiantes.",paragraph,254,48,1698,1952
info_cubo_matriEEPP_v11.md,"• Tipo:
Permite clasificar los datos en función de la tipología recogida en el marco del Reglamento de Formación Permanente.",paragraph,124,22,1954,2078
info_cubo_matriEEPP_v11.md,">Valores posibles: Máster Propio, Experto Universitario, Diploma de Especialización, Certificación de Extensi
Universitaria, Diploma de Extensión Universitaria.",paragraph,160,24,2080,2240
info_cubo_matriEEPP_v11.md,"• Órgano Gestión:
Permite clasificar los datos en función del centro encargado de la gestión administrativa de las enseñanzas.",paragraph,126,21,2242,2368
info_cubo_matriEEPP_v11.md,"• Órgano Proponente:
Permite clasificar los datos en función del centro responsable de la impartición de las enseñanzas.",paragraph,120,20,2370,2490
info_cubo_matriEEPP_v11.md,## DIMENSION: Fecha de actualización ##,paragraph,39,9,2492,2531
info_cubo_matriEEPP_v11.md,"Notas generales:
- Indica la fecha de la última recarga de datos. Habitualmente es el domingo anterior a la consulta de datos.",paragraph,126,25,2533,2659
info_cubo_matriEEPP_v11.md,"=== MEDIDAS ===

** Alumnos Matriculados **
Número total de estudiantes matriculados en Estudios Propios.",sentence,105,18,0,105
info_cubo_matriEEPP_v11.md,>Se debe introducir en la consulta la dimensión “CURSO ACADÉMICO”.,sentence,66,14,105,171
info_cubo_matriEEPP_v11.md,"De esta forma se evita acumular el to
de estudiantes de todos los cursos.",sentence,73,15,173,246
info_cubo_matriEEPP_v11.md,"=== DIMENSIONES ===

## DIMENSION: Alumno ##

Atributos:
• País Nacionalidad:
Permite clasificar los datos en función del país de nacionalidad legal de los estudiantes.",sentence,168,31,247,415
info_cubo_matriEEPP_v11.md,"• País Procedencia:
Identifica el país de residencia familiar indicado por el estudiante en SIGMA.",sentence,98,17,417,515
info_cubo_matriEEPP_v11.md,"• Rango de Edad:
Permite agrupar los rangos de edad de los estudiantes en función de su edad a fecha 31 de diciembre del cur académico en que están matriculados.",sentence,161,32,517,678
info_cubo_matriEEPP_v11.md,">Valores posibles: 18 años o menos, 19, 20, 21, 22, 23, 24, 25, 26, 27, 28, 29, 30 a 34, 35 a 39, 40 a 44, 45 a 4
50 a 54, 55 a 59, 60 a 64, 65 años o más.",sentence,155,63,680,835
info_cubo_matriEEPP_v11.md,"• Sexo:
Permite agrupar los estudiantes en función de su sexo.",sentence,62,13,837,899
info_cubo_matriEEPP_v11.md,"## DIMENSION: CURSO ACADÉMICO ##

Notas generales:
- Identifica los diferentes cursos académicos (por ejemplo 2013/14) de matrícula de los estudiantes.",sentence,151,28,901,1052
info_cubo_matriEEPP_v11.md,"## DIMENSION: Estudio Propio ##

Atributos:
• Duración (cursos):
Permite clasificar los datos en función del número de cursos de que consta el estudio.",sentence,151,32,1054,1205
info_cubo_matriEEPP_v11.md,"• Edición:
Permite clasificar los datos en función del número de edición de los cursos desde su implantación.",sentence,109,20,1207,1316
info_cubo_matriEEPP_v11.md,"• Modalidad:
Permite clasificar los datos en función de la presencialidad del estudio.",sentence,86,15,1318,1404
info_cubo_matriEEPP_v11.md,">Valores posibles: Presencial, Semipresencial, Semipresencial/On-line, Presencial/Semipresencial/On-line,
Presencial/Semipresencial, Presencial / On line, On line.",sentence,163,22,1406,1569
info_cubo_matriEEPP_v11.md,"• Nombre:
Permite clasificar los datos en función del estudio (código y denominación) en que se matriculan los estudiantes.",sentence,123,23,1571,1694
info_cubo_matriEEPP_v11.md,"• Rama:
Permite clasificar los datos en función de la Rama de Conocimiento (Artes y Humanidades, Ciencias, Ciencias Sociales y Jurídicas, Ciencias de la Salud, Ingeniería y Arquitectura) a la que pertenece el estudio en que se matriculan los estudiantes.",sentence,254,48,1696,1950
info_cubo_matriEEPP_v11.md,"• Tipo:
Permite clasificar los datos en función de la tipología recogida en el marco del Reglamento de Formación Permanente.",sentence,124,22,1952,2076
info_cubo_matriEEPP_v11.md,">Valores posibles: Máster Propio, Experto Universitario, Diploma de Especialización, Certificación de Extensi
Universitaria, Diploma de Extensión Universitaria.",sentence,160,24,2078,2238
info_cubo_matriEEPP_v11.md,"• Órgano Gestión:
Permite clasificar los datos en función del centro encargado de la gestión administrativa de las enseñanzas.",sentence,126,21,2240,2366
info_cubo_matriEEPP_v11.md,"• Órgano Proponente:
Permite clasificar los datos en función del centro responsable de la impartición de las enseñanzas.",sentence,120,20,2368,2488
info_cubo_matriEEPP_v11.md,"## DIMENSION: Fecha de actualización ##

Notas generales:
- Indica la fecha de la última recarga de datos.",sentence,106,23,2490,2596
info_cubo_matriEEPP_v11.md,Habitualmente es el domingo anterior a la consulta de datos.,sentence,60,11,2598,2658
info_cubo_movilidad_idi_v11.md,"=== MEDIDAS ===

** Movilidad **
Número de movilidades de entrada realizadas.

>Se recomienda utilizar la dimensión 'año de la movilidad' para filtrar esta medida en una fecha concreta.",section,186,35,0,186
info_cubo_movilidad_idi_v11.md,=== DIMENSIONES ===,section,20,3,187,207
info_cubo_movilidad_idi_v11.md,"## DIMENSION: AÑO ##

Notas generales:
- Permite clasificar las movilidades en función del año en que se realizaron.",section,117,24,208,325
info_cubo_movilidad_idi_v11.md,"## DIMENSION: Fecha de actualización ##

Notas generales:
- Es la fecha de la última recarga de datos.",section,103,23,326,429
info_cubo_movilidad_idi_v11.md,"## DIMENSION: Investigador ##

Atributos:
• Edad:
Permite agrupar los rangos de edad de los investigadores en función de su fecha de nacimiento.

>Valores posibles: 20 años o menos, 21 a 30, 31 a 40, 41 a 50, 51 a 60, 60 años o más.

• Grupo de investigación:
Permite clasificar los datos en función del grupo de investigación al que pertenecen los investigadores.

• Instituto de investigación:
Permite clasificar los datos en función del instituto universitario de investigación al que pertenecen los investigadores.

• Macroárea:
Permite clasificar los datos en función de la macroárea a la que pertenecen los investigadores.

>Valores posibles: Artes y Humanidades, Ciencias, Ciencias Sociales y Jurídicas, Ciencias de la Salud, Ingeniería y
Arquitectura.

• Nacionalidad:
Permite clasificar los datos en función de la nacionalidad legal de los investigadores.

• Sexo:
Permite agrupar a los investigadores en función de su sexo.",section,934,176,430,1364
info_cubo_movilidad_idi_v11.md,"## DIMENSION: Movilidad ##

Atributos:
• Duración:
Permite clasificar los datos en función de la duración de la movilidad en semanas.

• Fecha de finalización:
Permite clasificar los datos en función de la fecha de finalización de la movilidad (año, trimestre, mes, día).

• Fecha de inicio:
Permite clasificar los datos en función de la fecha de inicio de la movilidad (año, trimestre, mes, día).

• Prórroga:
Permite identificar los investigadores que realizan una prórroga de su movilidad (S) o no (N).

• Tipo de entidad origen:
Permite identificar el tipo de entidad de origen del investigador que realiza la movilidad.

>Valores posibles: empresa, universidad, unidad de investigación.

• Tipo de movilidad:
Permite clasificar las movilidades en función de su tipología (estancia o vinculación).",section,803,161,1365,2168
info_cubo_movilidad_idi_v11.md,=== MEDIDAS ===,paragraph,15,3,0,15
info_cubo_movilidad_idi_v11.md,"** Movilidad **
Número de movilidades de entrada realizadas.",paragraph,60,12,17,77
info_cubo_movilidad_idi_v11.md,>Se recomienda utilizar la dimensión 'año de la movilidad' para filtrar esta medida en una fecha concreta.,paragraph,106,20,79,185
info_cubo_movilidad_idi_v11.md,=== DIMENSIONES ===,paragraph,19,3,187,206
info_cubo_movilidad_idi_v11.md,## DIMENSION: AÑO ##,paragraph,20,7,208,228
info_cubo_movilidad_idi_v11.md,"Notas generales:
- Permite clasificar las movilidades en función del año en que se realizaron.",paragraph,94,17,230,324
info_cubo_movilidad_idi_v11.md,## DIMENSION: Fecha de actualización ##,paragraph,39,9,326,365
info_cubo_movilidad_idi_v11.md,"Notas generales:
- Es la fecha de la última recarga de datos.",paragraph,61,14,367,428
info_cubo_movilidad_idi_v11.md,## DIMENSION: Investigador ##,paragraph,29,7,430,459
info_cubo_movilidad_idi_v11.md,"Atributos:
• Edad:
Permite agrupar los rangos de edad de los investigadores en función de su fecha de nacimiento.",paragraph,113,22,461,574
info_cubo_movilidad_idi_v11.md,">Valores posibles: 20 años o menos, 21 a 30, 31 a 40, 41 a 50, 51 a 60, 60 años o más.",paragraph,86,30,576,662
info_cubo_movilidad_idi_v11.md,"• Grupo de investigación:
Permite clasificar los datos en función del grupo de investigación al que pertenecen los investigadores.",paragraph,130,21,664,794
info_cubo_movilidad_idi_v11.md,"• Instituto de investigación:
Permite clasificar los datos en función del instituto universitario de investigación al que pertenecen los investigadores.",paragraph,152,22,796,948
info_cubo_movilidad_idi_v11.md,"• Macroárea:
Permite clasificar los datos en función de la macroárea a la que pertenecen los investigadores.",paragraph,108,19,950,1058
info_cubo_movilidad_idi_v11.md,">Valores posibles: Artes y Humanidades, Ciencias, Ciencias Sociales y Jurídicas, Ciencias de la Salud, Ingeniería y
Arquitectura.",paragraph,129,24,1060,1189
info_cubo_movilidad_idi_v11.md,"• Nacionalidad:
Permite clasificar los datos en función de la nacionalidad legal de los investigadores.",paragraph,103,17,1191,1294
info_cubo_movilidad_idi_v11.md,"• Sexo:
Permite agrupar a los investigadores en función de su sexo.",paragraph,67,14,1296,1363
info_cubo_movilidad_idi_v11.md,## DIMENSION: Movilidad ##,paragraph,26,7,1365,1391
info_cubo_movilidad_idi_v11.md,"Atributos:
• Duración:
Permite clasificar los datos en función de la duración de la movilidad en semanas.",paragraph,105,20,1393,1498
info_cubo_movilidad_idi_v11.md,"• Fecha de finalización:
Permite clasificar los datos en función de la fecha de finalización de la movilidad (año, trimestre, mes, día).",paragraph,136,29,1500,1636
info_cubo_movilidad_idi_v11.md,"• Fecha de inicio:
Permite clasificar los datos en función de la fecha de inicio de la movilidad (año, trimestre, mes, día).",paragraph,124,29,1638,1762
info_cubo_movilidad_idi_v11.md,"• Prórroga:
Permite identificar los investigadores que realizan una prórroga de su movilidad (S) o no (N).",paragraph,106,23,1764,1870
info_cubo_movilidad_idi_v11.md,"• Tipo de entidad origen:
Permite identificar el tipo de entidad de origen del investigador que realiza la movilidad.",paragraph,117,21,1872,1989
info_cubo_movilidad_idi_v11.md,">Valores posibles: empresa, universidad, unidad de investigación.",paragraph,65,12,1991,2056
info_cubo_movilidad_idi_v11.md,"• Tipo de movilidad:
Permite clasificar las movilidades en función de su tipología (estancia o vinculación).",paragraph,108,20,2058,2166
info_cubo_movilidad_idi_v11.md,"=== MEDIDAS ===

** Movilidad **
Número de movilidades de entrada realizadas.",sentence,77,15,0,77
info_cubo_movilidad_idi_v11.md,>Se recomienda utilizar la dimensión 'año de la movilidad' para filtrar esta medida en una fecha concreta.,sentence,106,20,77,183
info_cubo_movilidad_idi_v11.md,"=== DIMENSIONES ===

## DIMENSION: AÑO ##

Notas generales:
- Permite clasificar las movilidades en función del año en que se realizaron.",sentence,137,27,185,322
info_cubo_movilidad_idi_v11.md,"## DIMENSION: Fecha de actualización ##

Notas generales:
- Es la fecha de la última recarga de datos.",sentence,102,23,324,426
info_cubo_movilidad_idi_v11.md,"## DIMENSION: Investigador ##

Atributos:
• Edad:
Permite agrupar los rangos de edad de los investigadores en función de su fecha de nacimiento.",sentence,144,29,428,572
info_cubo_movilidad_idi_v11.md,">Valores posibles: 20 años o menos, 21 a 30, 31 a 40, 41 a 50, 51 a 60, 60 años o más.",sentence,86,30,574,660
info_cubo_movilidad_idi_v11.md,"• Grupo de investigación:
Permite clasificar los datos en función del grupo de investigación al que pertenecen los investigadores.",sentence,130,21,662,792
info_cubo_movilidad_idi_v11.md,"• Instituto de investigación:
Permite clasificar los datos en función del instituto universitario de investigación al que pertenecen los investigadores.",sentence,152,22,794,946
info_cubo_movilidad_idi_v11.md,"• Macroárea:
Permite clasificar los datos en función de la macroárea a la que pertenecen los investigadores.",sentence,108,19,948,1056
info_cubo_movilidad_idi_v11.md,">Valores posibles: Artes y Humanidades, Ciencias, Ciencias Sociales y Jurídicas, Ciencias de la Salud, Ingeniería y
Arquitectura.",sentence,129,24,1058,1187
info_cubo_movilidad_idi_v11.md,"• Nacionalidad:
Permite clasificar los datos en función de la nacionalidad legal de los investigadores.",sentence,103,17,1189,1292
info_cubo_movilidad_idi_v11.md,"• Sexo:
Permite agrupar a los investigadores en función de su sexo.",sentence,67,14,1294,1361
info_cubo_movilidad_idi_v11.md,"## DIMENSION: Movilidad ##

Atributos:
• Duración:
Permite clasificar los datos en función de la duración de la movilidad en semanas.",sentence,133,27,1363,1496
info_cubo_movilidad_idi_v11.md,"• Fecha de finalización:
Permite clasificar los datos en función de la fecha de finalización de la movilidad (año, trimestre, mes, día).",sentence,136,29,1498,1634
info_cubo_movilidad_idi_v11.md,"• Fecha de inicio:
Permite clasificar los datos en función de la fecha de inicio de la movilidad (año, trimestre, mes, día).",sentence,124,29,1636,1760
info_cubo_movilidad_idi_v11.md,"• Prórroga:
Permite identificar los investigadores que realizan una prórroga de su movilidad (S) o no (N).",sentence,106,23,1762,1868
info_cubo_movilidad_idi_v11.md,"• Tipo de entidad origen:
Permite identificar el tipo de entidad de origen del investigador que realiza la movilidad.",sentence,117,21,1870,1987
info_cubo_movilidad_idi_v11.md,">Valores posibles: empresa, universidad, unidad de investigación.",sentence,65,12,1989,2054
info_cubo_movilidad_idi_v11.md,"• Tipo de movilidad:
Permite clasificar las movilidades en función de su tipología (estancia o vinculación).",sentence,108,20,2056,2164
info_cubo_ofertaplazas_v18.md,"=== MEDIDAS ===

** Plazas ofertadas **
Oferta de plazas de estudiantes de nuevo ingreso para cada curso académico, aprobada por el Consejo Gobierno de la UZ, comunicada al Consejo General de Política Universitaria para su estudio y determinaci y publicada finalmente en el Boletín Oficial del Estado.

** Plazas matriculadas **
Número de plazas ocupadas por matriculados de nuevo ingreso. Observaciones:

>Se identifica con la persona que se matricula en un plan de estudios, consumiendo alguna de las pla
ofertadas para ese año y plan.

>No se consideran matriculados de nuevo ingreso los que acceden a un estudio por el procedimiento
cambio de estudios, traslado de expediente o de adaptación al grado.

** Plazas solicitadas **
Número de peticiones de acceso a un plan de estudios presentadas por los estudiantes que cumplen algu de los requisitos de acceso a la Universidad que marca la legislación vigente. Observaciones:

>Cada solicitante se cuenta tantas veces como cupos de adjudicación haga constar en su solicitud
admisión. Por tanto, puede variar la cifra de plazas solicitadas en el cubo de oferta respecto de la cifra solicitudes que se obtiene en el cubo de admisión.

** Nota corte adjudicación 1 **
Nota más baja de admisión de entre la totalidad de admitidos en un estudio, calculada en el momento la adjudicación de plazas de la convocatoria ordinaria. Observaciones:

>Se recomienda introducir en la consulta la dimensión ""cupo de adjudicación"" para poder conocer la n
de cada cupo. De lo contrario, se publicará la menor nota de entre todos los cupos, que podrá ser inferio la menor nota del cupo general (EVAU-PAU, CFGS, Credencial UNED).

** Nota corte definitiva 1 **
Nota más baja de admisión de entre la totalidad de admitidos en un estudio en la convocatoria ordinar calculada a fecha 31 de diciembre del curso académico que se seleccione. Incluye el efecto que sobre listas de admisión tienen los llamamientos y la resolución de recursos. Observaciones:

>Se recomienda introducir en la consulta la dimensión ""cupo de adjudicación"" para poder conocer la n
de cada cupo. De lo contrario, se publicará la menor nota de entre todos los cupos, que podrá ser inferio la menor nota del cupo general (EVAU-PAU, CFGS, Credencial UNED).

>Una nota de corte de 5,000 en un cupo determinado significa que todos los solicitantes por ese cupo h
sido admitidos.

** Nota corte adjudicación 2 **
Nota más baja de admisión de entre la totalidad de admitidos en un estudio, calculada en el momento la adjudicación de plazas de la convocatoria extraordinaria. Observaciones:

>Se recomienda introducir en la consulta la dimensión ""cupo de adjudicación"" para poder conocer la n
de cada cupo. De lo contrario, se publicará la menor nota de entre todos los cupos, que podrá ser inferio la menor nota del cupo general (EVAU-PAU, CFGS, Credencial UNED).

>Si se consultan datos anteriores al curso 2017/18 es conveniente introducir la dimensión “Prelación Con
Nota de Corte”, puesto que los solicitantes del cupo general que superaron la prueba de acceso en convocatoria ordinaria o en años anteriores tenían siempre preferencia sobre los que superaron la prue de acceso en la convocatoria extraordinaria del año consultado, independientemente de la nota obteni en esta convocatoria.

>Si la nota de corte aparece en blanco en un plan de estudios o cupo de adjudicación, quiere decir que
ha habido segunda fase de admisión para ese plan o cupo.

** Nota corte definitiva 2 **
Nota más baja de admisión de entre la totalidad de admitidos en un estudio en la convocato extraordinaria, calculada a fecha 31 de diciembre del curso académico que se seleccione. Incluye el efe que sobre las listas de admisión tienen los llamamientos y la resolución de recursos. Observaciones:

>Se recomienda introducir en la consulta la dimensión ""cupo de adjudicación"" para poder conocer la n
de cada cupo. De lo contrario, se publicará la menor nota de entre todos los cupos, que podrá ser inferio la menor nota del cupo general (EVAU-PAU, CFGS, Credencial UNED).

>Si se consultan datos anteriores al curso 2017/18 es conveniente introducir la dimensión “Prelación Con
Nota de Corte”, puesto que los solicitantes del cupo general que superaron la prueba de acceso en convocatoria ordinaria o en años anteriores tenían siempre preferencia sobre los que superaron la prue de acceso en la convocatoria extraordinaria del año consultado, independientemente de la nota obteni en esta convocatoria.

>Una nota de corte de 5,000 en un cupo determinado significa que todos los solicitantes por ese cupo h
sido admitidos.

>Si la nota de corte aparece en blanco en un plan de estudios o cupo de adjudicación, quiere decir que
ha habido segunda fase de admisión para ese plan o cupo.",section,4763,890,0,4763
info_cubo_ofertaplazas_v18.md,=== DIMENSIONES ===,section,20,3,4764,4784
info_cubo_ofertaplazas_v18.md,"## DIMENSION: CURSO ACADÉMICO ##

Notas generales:
- Identifica los diferentes cursos académicos (por ejemplo 2021/22).",section,120,23,4785,4905
info_cubo_ofertaplazas_v18.md,"## DIMENSION: Centro ##

Notas generales:
- Permite clasificar los datos en función del centro en que se ofertan las plazas.

Atributos:
• Campus:
Permite clasificar los datos en función del campus en que se ubica el centro en que se ofertan las plazas.

• Localidad:
Permite clasificar los datos en función de la localidad en que se ubica el centro en que se ofertan las plaz

• Tipo:
Permite clasificar los datos en función del tipo de centro (facultad, escuela universitaria, centro adscri etc.)en que se ofertan las plazas.",section,528,107,4906,5434
info_cubo_ofertaplazas_v18.md,"## DIMENSION: Cupo de Adjudicación ##

Notas generales:
- Clasifica las plazas en función de si participan del cupo general (EVAU-PAU, CFGS, Credencial UNED) o de de reserva (titulados universitarios o equivalentes, mayores de 25 años, mayores de 45 años, mayores 40 años con experiencia profesional, discapacitados, deportistas de alto nivel o de alto rendimiento).",section,367,71,5435,5802
info_cubo_ofertaplazas_v18.md,"## DIMENSION: Estudio Previo ##

Notas generales:
- Identifica la clase de estudio cursado anteriormente por los solicitantes, que les da acceso a la Universid de acuerdo con los requisitos establecidos por la legislación vigente.

>Valores posibles: Pruebas de Acceso, COU sin PAU, FP, Titulados Universitarios, Mayores de 25, Mayo
de 40, Mayores de 45",section,354,69,5803,6157
info_cubo_ofertaplazas_v18.md,"## DIMENSION: Fecha de actualización ##

Notas generales:
- Indica la fecha de la última recarga de datos. Habitualmente es el domingo anterior a la consulta de dato",section,166,33,6158,6324
info_cubo_ofertaplazas_v18.md,"## DIMENSION: Prelación Convo Nota de Corte ##

Notas generales:
- Indica si la nota de corte corresponde a un solicitante del cupo general de la convocatoria ordinaria o años anteriores (J), o bien de la convocatoria de extraordinaria (S). Observaciones:

>Esta variable es imprescindible para entender las notas de corte del cupo general en la convocato
extraordinaria, puesto que los solicitantes de esta vía que superaron la prueba de acceso en la convocato ordinaria o en años anteriores tienen siempre preferencia sobre los que superan la prueba de acceso en convocatoria extraordinaria, independientemente de su nota de admisión.

>IMPORTANTE: la prioridad ha dejado de tener vigencia a partir del curso académico 2017/18.",section,730,131,6325,7055
info_cubo_ofertaplazas_v18.md,"## DIMENSION: Tipo de Acceso ##

Notas generales:
- Clasifica las plazas según se correspondan con el proceso general de preinscripción a grados (Preinscripció o con el proceso de admisión a máster (acceso a ciclos).",section,217,43,7056,7273
info_cubo_ofertaplazas_v18.md,"## DIMENSION: Titulación ##

Atributos:
• Estudio:
Permite identificar el estudio ofertado.

• Plan de estudios:
Permite identificar el plan de estudios ofertado.

• Rama de Conocimiento:
Permite identificar la rama de conocimiento (Artes y Humanidades, Ciencias, Ciencias Sociales y Jurídic Ciencias de la Salud, Ingeniería y Arquitectura) a la que se asigna el plan de estudios ofertado.

• Tipo de estudio:
Permite identificar el tipo de titulación ofertada: grado, licenciatura o equivalente, diplomatura equivalente.",section,523,95,7274,7797
info_cubo_ofertaplazas_v18.md,=== MEDIDAS ===,paragraph,15,3,0,15
info_cubo_ofertaplazas_v18.md,"** Plazas ofertadas **
Oferta de plazas de estudiantes de nuevo ingreso para cada curso académico, aprobada por el Consejo Gobierno de la UZ, comunicada al Consejo General de Política Universitaria para su estudio y determinaci y publicada finalmente en el Boletín Oficial del Estado.",paragraph,284,50,17,301
info_cubo_ofertaplazas_v18.md,"** Plazas matriculadas **
Número de plazas ocupadas por matriculados de nuevo ingreso. Observaciones:",paragraph,101,18,303,404
info_cubo_ofertaplazas_v18.md,">Se identifica con la persona que se matricula en un plan de estudios, consumiendo alguna de las pla
ofertadas para ese año y plan.",paragraph,131,27,406,537
info_cubo_ofertaplazas_v18.md,">No se consideran matriculados de nuevo ingreso los que acceden a un estudio por el procedimiento
cambio de estudios, traslado de expediente o de adaptación al grado.",paragraph,166,30,539,705
info_cubo_ofertaplazas_v18.md,"** Plazas solicitadas **
Número de peticiones de acceso a un plan de estudios presentadas por los estudiantes que cumplen algu de los requisitos de acceso a la Universidad que marca la legislación vigente. Observaciones:",paragraph,220,39,707,927
info_cubo_ofertaplazas_v18.md,">Cada solicitante se cuenta tantas veces como cupos de adjudicación haga constar en su solicitud
admisión. Por tanto, puede variar la cifra de plazas solicitadas en el cubo de oferta respecto de la cifra solicitudes que se obtiene en el cubo de admisión.",paragraph,254,47,929,1183
info_cubo_ofertaplazas_v18.md,"** Nota corte adjudicación 1 **
Nota más baja de admisión de entre la totalidad de admitidos en un estudio, calculada en el momento la adjudicación de plazas de la convocatoria ordinaria. Observaciones:",paragraph,202,38,1185,1387
info_cubo_ofertaplazas_v18.md,">Se recomienda introducir en la consulta la dimensión ""cupo de adjudicación"" para poder conocer la n
de cada cupo. De lo contrario, se publicará la menor nota de entre todos los cupos, que podrá ser inferio la menor nota del cupo general (EVAU-PAU, CFGS, Credencial UNED).",paragraph,272,57,1389,1661
info_cubo_ofertaplazas_v18.md,"** Nota corte definitiva 1 **
Nota más baja de admisión de entre la totalidad de admitidos en un estudio en la convocatoria ordinar calculada a fecha 31 de diciembre del curso académico que se seleccione. Incluye el efecto que sobre listas de admisión tienen los llamamientos y la resolución de recursos. Observaciones:",paragraph,319,58,1663,1982
info_cubo_ofertaplazas_v18.md,">Se recomienda introducir en la consulta la dimensión ""cupo de adjudicación"" para poder conocer la n
de cada cupo. De lo contrario, se publicará la menor nota de entre todos los cupos, que podrá ser inferio la menor nota del cupo general (EVAU-PAU, CFGS, Credencial UNED).",paragraph,272,57,1984,2256
info_cubo_ofertaplazas_v18.md,">Una nota de corte de 5,000 en un cupo determinado significa que todos los solicitantes por ese cupo h
sido admitidos.",paragraph,118,23,2258,2376
info_cubo_ofertaplazas_v18.md,"** Nota corte adjudicación 2 **
Nota más baja de admisión de entre la totalidad de admitidos en un estudio, calculada en el momento la adjudicación de plazas de la convocatoria extraordinaria. Observaciones:",paragraph,207,38,2378,2585
info_cubo_ofertaplazas_v18.md,">Se recomienda introducir en la consulta la dimensión ""cupo de adjudicación"" para poder conocer la n
de cada cupo. De lo contrario, se publicará la menor nota de entre todos los cupos, que podrá ser inferio la menor nota del cupo general (EVAU-PAU, CFGS, Credencial UNED).",paragraph,272,57,2587,2859
info_cubo_ofertaplazas_v18.md,">Si se consultan datos anteriores al curso 2017/18 es conveniente introducir la dimensión “Prelación Con
Nota de Corte”, puesto que los solicitantes del cupo general que superaron la prueba de acceso en convocatoria ordinaria o en años anteriores tenían siempre preferencia sobre los que superaron la prue de acceso en la convocatoria extraordinaria del año consultado, independientemente de la nota obteni en esta convocatoria.",paragraph,428,70,2861,3289
info_cubo_ofertaplazas_v18.md,">Si la nota de corte aparece en blanco en un plan de estudios o cupo de adjudicación, quiere decir que
ha habido segunda fase de admisión para ese plan o cupo.",paragraph,159,34,3291,3450
info_cubo_ofertaplazas_v18.md,"** Nota corte definitiva 2 **
Nota más baja de admisión de entre la totalidad de admitidos en un estudio en la convocato extraordinaria, calculada a fecha 31 de diciembre del curso académico que se seleccione. Incluye el efe que sobre las listas de admisión tienen los llamamientos y la resolución de recursos. Observaciones:",paragraph,325,60,3452,3777
info_cubo_ofertaplazas_v18.md,">Se recomienda introducir en la consulta la dimensión ""cupo de adjudicación"" para poder conocer la n
de cada cupo. De lo contrario, se publicará la menor nota de entre todos los cupos, que podrá ser inferio la menor nota del cupo general (EVAU-PAU, CFGS, Credencial UNED).",paragraph,272,57,3779,4051
info_cubo_ofertaplazas_v18.md,">Si se consultan datos anteriores al curso 2017/18 es conveniente introducir la dimensión “Prelación Con
Nota de Corte”, puesto que los solicitantes del cupo general que superaron la prueba de acceso en convocatoria ordinaria o en años anteriores tenían siempre preferencia sobre los que superaron la prue de acceso en la convocatoria extraordinaria del año consultado, independientemente de la nota obteni en esta convocatoria.",paragraph,428,70,4053,4481
info_cubo_ofertaplazas_v18.md,">Una nota de corte de 5,000 en un cupo determinado significa que todos los solicitantes por ese cupo h
sido admitidos.",paragraph,118,23,4483,4601
info_cubo_ofertaplazas_v18.md,">Si la nota de corte aparece en blanco en un plan de estudios o cupo de adjudicación, quiere decir que
ha habido segunda fase de admisión para ese plan o cupo.",paragraph,159,34,4603,4762
info_cubo_ofertaplazas_v18.md,=== DIMENSIONES ===,paragraph,19,3,4764,4783
info_cubo_ofertaplazas_v18.md,## DIMENSION: CURSO ACADÉMICO ##,paragraph,32,8,4785,4817
info_cubo_ofertaplazas_v18.md,"Notas generales:
- Identifica los diferentes cursos académicos (por ejemplo 2021/22).",paragraph,85,15,4819,4904
info_cubo_ofertaplazas_v18.md,## DIMENSION: Centro ##,paragraph,23,7,4906,4929
info_cubo_ofertaplazas_v18.md,"Notas generales:
- Permite clasificar los datos en función del centro en que se ofertan las plazas.",paragraph,99,19,4931,5030
info_cubo_ofertaplazas_v18.md,"Atributos:
• Campus:
Permite clasificar los datos en función del campus en que se ubica el centro en que se ofertan las plazas.",paragraph,127,26,5032,5159
info_cubo_ofertaplazas_v18.md,"• Localidad:
Permite clasificar los datos en función de la localidad en que se ubica el centro en que se ofertan las plaz",paragraph,121,24,5161,5282
info_cubo_ofertaplazas_v18.md,"• Tipo:
Permite clasificar los datos en función del tipo de centro (facultad, escuela universitaria, centro adscri etc.)en que se ofertan las plazas.",paragraph,149,31,5284,5433
info_cubo_ofertaplazas_v18.md,## DIMENSION: Cupo de Adjudicación ##,paragraph,37,9,5435,5472
info_cubo_ofertaplazas_v18.md,"Notas generales:
- Clasifica las plazas en función de si participan del cupo general (EVAU-PAU, CFGS, Credencial UNED) o de de reserva (titulados universitarios o equivalentes, mayores de 25 años, mayores de 45 años, mayores 40 años con experiencia profesional, discapacitados, deportistas de alto nivel o de alto rendimiento).",paragraph,327,62,5474,5801
info_cubo_ofertaplazas_v18.md,## DIMENSION: Estudio Previo ##,paragraph,31,8,5803,5834
info_cubo_ofertaplazas_v18.md,"Notas generales:
- Identifica la clase de estudio cursado anteriormente por los solicitantes, que les da acceso a la Universid de acuerdo con los requisitos establecidos por la legislación vigente.",paragraph,197,33,5836,6033
info_cubo_ofertaplazas_v18.md,">Valores posibles: Pruebas de Acceso, COU sin PAU, FP, Titulados Universitarios, Mayores de 25, Mayo
de 40, Mayores de 45",paragraph,121,28,6035,6156
info_cubo_ofertaplazas_v18.md,## DIMENSION: Fecha de actualización ##,paragraph,39,9,6158,6197
info_cubo_ofertaplazas_v18.md,"Notas generales:
- Indica la fecha de la última recarga de datos. Habitualmente es el domingo anterior a la consulta de dato",paragraph,124,24,6199,6323
info_cubo_ofertaplazas_v18.md,## DIMENSION: Prelación Convo Nota de Corte ##,paragraph,46,11,6325,6371
info_cubo_ofertaplazas_v18.md,"Notas generales:
- Indica si la nota de corte corresponde a un solicitante del cupo general de la convocatoria ordinaria o años anteriores (J), o bien de la convocatoria de extraordinaria (S). Observaciones:",paragraph,207,41,6373,6580
info_cubo_ofertaplazas_v18.md,">Esta variable es imprescindible para entender las notas de corte del cupo general en la convocato
extraordinaria, puesto que los solicitantes de esta vía que superaron la prueba de acceso en la convocato ordinaria o en años anteriores tienen siempre preferencia sobre los que superan la prueba de acceso en convocatoria extraordinaria, independientemente de su nota de admisión.",paragraph,379,62,6582,6961
info_cubo_ofertaplazas_v18.md,>IMPORTANTE: la prioridad ha dejado de tener vigencia a partir del curso académico 2017/18.,paragraph,91,17,6963,7054
info_cubo_ofertaplazas_v18.md,## DIMENSION: Tipo de Acceso ##,paragraph,31,9,7056,7087
info_cubo_ofertaplazas_v18.md,"Notas generales:
- Clasifica las plazas según se correspondan con el proceso general de preinscripción a grados (Preinscripció o con el proceso de admisión a máster (acceso a ciclos).",paragraph,183,34,7089,7272
info_cubo_ofertaplazas_v18.md,## DIMENSION: Titulación ##,paragraph,27,7,7274,7301
info_cubo_ofertaplazas_v18.md,"Atributos:
• Estudio:
Permite identificar el estudio ofertado.",paragraph,62,11,7303,7365
info_cubo_ofertaplazas_v18.md,"• Plan de estudios:
Permite identificar el plan de estudios ofertado.",paragraph,69,13,7367,7436
info_cubo_ofertaplazas_v18.md,"• Rama de Conocimiento:
Permite identificar la rama de conocimiento (Artes y Humanidades, Ciencias, Ciencias Sociales y Jurídic Ciencias de la Salud, Ingeniería y Arquitectura) a la que se asigna el plan de estudios ofertado.",paragraph,225,42,7438,7663
info_cubo_ofertaplazas_v18.md,"• Tipo de estudio:
Permite identificar el tipo de titulación ofertada: grado, licenciatura o equivalente, diplomatura equivalente.",paragraph,130,22,7665,7795
info_cubo_ofertaplazas_v18.md,"=== MEDIDAS ===

** Plazas ofertadas **
Oferta de plazas de estudiantes de nuevo ingreso para cada curso académico, aprobada por el Consejo Gobierno de la UZ, comunicada al Consejo General de Política Universitaria para su estudio y determinaci y publicada finalmente en el Boletín Oficial del Estado.",sentence,301,53,0,301
info_cubo_ofertaplazas_v18.md,"** Plazas matriculadas **
Número de plazas ocupadas por matriculados de nuevo ingreso.",sentence,86,16,301,387
info_cubo_ofertaplazas_v18.md,"Observaciones:

>Se identifica con la persona que se matricula en un plan de estudios, consumiendo alguna de las pla
ofertadas para ese año y plan.",sentence,147,29,389,536
info_cubo_ofertaplazas_v18.md,">No se consideran matriculados de nuevo ingreso los que acceden a un estudio por el procedimiento
cambio de estudios, traslado de expediente o de adaptación al grado.",sentence,166,30,537,703
info_cubo_ofertaplazas_v18.md,"** Plazas solicitadas **
Número de peticiones de acceso a un plan de estudios presentadas por los estudiantes que cumplen algu de los requisitos de acceso a la Universidad que marca la legislación vigente.",sentence,205,37,705,910
info_cubo_ofertaplazas_v18.md,"Observaciones:

>Cada solicitante se cuenta tantas veces como cupos de adjudicación haga constar en su solicitud
admisión.",sentence,122,20,912,1034
info_cubo_ofertaplazas_v18.md,"Por tanto, puede variar la cifra de plazas solicitadas en el cubo de oferta respecto de la cifra solicitudes que se obtiene en el cubo de admisión.",sentence,147,29,1035,1182
info_cubo_ofertaplazas_v18.md,"** Nota corte adjudicación 1 **
Nota más baja de admisión de entre la totalidad de admitidos en un estudio, calculada en el momento la adjudicación de plazas de la convocatoria ordinaria.",sentence,187,36,1183,1370
info_cubo_ofertaplazas_v18.md,"Observaciones:

>Se recomienda introducir en la consulta la dimensión ""cupo de adjudicación"" para poder conocer la n
de cada cupo.",sentence,130,25,1372,1502
info_cubo_ofertaplazas_v18.md,"De lo contrario, se publicará la menor nota de entre todos los cupos, que podrá ser inferio la menor nota del cupo general (EVAU-PAU, CFGS, Credencial UNED).",sentence,157,34,1503,1660
info_cubo_ofertaplazas_v18.md,"** Nota corte definitiva 1 **
Nota más baja de admisión de entre la totalidad de admitidos en un estudio en la convocatoria ordinar calculada a fecha 31 de diciembre del curso académico que se seleccione.",sentence,204,39,1661,1865
info_cubo_ofertaplazas_v18.md,Incluye el efecto que sobre listas de admisión tienen los llamamientos y la resolución de recursos.,sentence,99,17,1867,1966
info_cubo_ofertaplazas_v18.md,"Observaciones:

>Se recomienda introducir en la consulta la dimensión ""cupo de adjudicación"" para poder conocer la n
de cada cupo.",sentence,130,25,1967,2097
info_cubo_ofertaplazas_v18.md,"De lo contrario, se publicará la menor nota de entre todos los cupos, que podrá ser inferio la menor nota del cupo general (EVAU-PAU, CFGS, Credencial UNED).",sentence,157,34,2098,2255
info_cubo_ofertaplazas_v18.md,">Una nota de corte de 5,000 en un cupo determinado significa que todos los solicitantes por ese cupo h
sido admitidos.",sentence,118,23,2256,2374
info_cubo_ofertaplazas_v18.md,"** Nota corte adjudicación 2 **
Nota más baja de admisión de entre la totalidad de admitidos en un estudio, calculada en el momento la adjudicación de plazas de la convocatoria extraordinaria.",sentence,192,36,2376,2568
info_cubo_ofertaplazas_v18.md,"Observaciones:

>Se recomienda introducir en la consulta la dimensión ""cupo de adjudicación"" para poder conocer la n
de cada cupo.",sentence,130,25,2570,2700
info_cubo_ofertaplazas_v18.md,"De lo contrario, se publicará la menor nota de entre todos los cupos, que podrá ser inferio la menor nota del cupo general (EVAU-PAU, CFGS, Credencial UNED).",sentence,157,34,2701,2858
info_cubo_ofertaplazas_v18.md,">Si se consultan datos anteriores al curso 2017/18 es conveniente introducir la dimensión “Prelación Con
Nota de Corte”, puesto que los solicitantes del cupo general que superaron la prueba de acceso en convocatoria ordinaria o en años anteriores tenían siempre preferencia sobre los que superaron la prue de acceso en la convocatoria extraordinaria del año consultado, independientemente de la nota obteni en esta convocatoria.",sentence,428,70,2859,3287
info_cubo_ofertaplazas_v18.md,">Si la nota de corte aparece en blanco en un plan de estudios o cupo de adjudicación, quiere decir que
ha habido segunda fase de admisión para ese plan o cupo.",sentence,159,34,3289,3448
info_cubo_ofertaplazas_v18.md,"** Nota corte definitiva 2 **
Nota más baja de admisión de entre la totalidad de admitidos en un estudio en la convocato extraordinaria, calculada a fecha 31 de diciembre del curso académico que se seleccione.",sentence,209,40,3450,3659
info_cubo_ofertaplazas_v18.md,Incluye el efe que sobre las listas de admisión tienen los llamamientos y la resolución de recursos.,sentence,100,18,3661,3761
info_cubo_ofertaplazas_v18.md,"Observaciones:

>Se recomienda introducir en la consulta la dimensión ""cupo de adjudicación"" para poder conocer la n
de cada cupo.",sentence,130,25,3762,3892
info_cubo_ofertaplazas_v18.md,"De lo contrario, se publicará la menor nota de entre todos los cupos, que podrá ser inferio la menor nota del cupo general (EVAU-PAU, CFGS, Credencial UNED).",sentence,157,34,3893,4050
info_cubo_ofertaplazas_v18.md,">Si se consultan datos anteriores al curso 2017/18 es conveniente introducir la dimensión “Prelación Con
Nota de Corte”, puesto que los solicitantes del cupo general que superaron la prueba de acceso en convocatoria ordinaria o en años anteriores tenían siempre preferencia sobre los que superaron la prue de acceso en la convocatoria extraordinaria del año consultado, independientemente de la nota obteni en esta convocatoria.",sentence,428,70,4051,4479
info_cubo_ofertaplazas_v18.md,">Una nota de corte de 5,000 en un cupo determinado significa que todos los solicitantes por ese cupo h
sido admitidos.",sentence,118,23,4481,4599
info_cubo_ofertaplazas_v18.md,">Si la nota de corte aparece en blanco en un plan de estudios o cupo de adjudicación, quiere decir que
ha habido segunda fase de admisión para ese plan o cupo.",sentence,159,34,4601,4760
info_cubo_ofertaplazas_v18.md,"=== DIMENSIONES ===

## DIMENSION: CURSO ACADÉMICO ##

Notas generales:
- Identifica los diferentes cursos académicos (por ejemplo 2021/22).",sentence,140,26,4762,4902
info_cubo_ofertaplazas_v18.md,"## DIMENSION: Centro ##

Notas generales:
- Permite clasificar los datos en función del centro en que se ofertan las plazas.",sentence,124,26,4904,5028
info_cubo_ofertaplazas_v18.md,"Atributos:
• Campus:
Permite clasificar los datos en función del campus en que se ubica el centro en que se ofertan las plazas.",sentence,127,26,5030,5157
info_cubo_ofertaplazas_v18.md,"• Localidad:
Permite clasificar los datos en función de la localidad en que se ubica el centro en que se ofertan las plaz

• Tipo:
Permite clasificar los datos en función del tipo de centro (facultad, escuela universitaria, centro adscri etc.",sentence,242,47,5159,5401
info_cubo_ofertaplazas_v18.md,)en que se ofertan las plazas.,sentence,30,8,5403,5433
info_cubo_ofertaplazas_v18.md,"## DIMENSION: Cupo de Adjudicación ##

Notas generales:
- Clasifica las plazas en función de si participan del cupo general (EVAU-PAU, CFGS, Credencial UNED) o de de reserva (titulados universitarios o equivalentes, mayores de 25 años, mayores de 45 años, mayores 40 años con experiencia profesional, discapacitados, deportistas de alto nivel o de alto rendimiento).",sentence,366,71,5433,5799
info_cubo_ofertaplazas_v18.md,"## DIMENSION: Estudio Previo ##

Notas generales:
- Identifica la clase de estudio cursado anteriormente por los solicitantes, que les da acceso a la Universid de acuerdo con los requisitos establecidos por la legislación vigente.",sentence,230,41,5801,6031
info_cubo_ofertaplazas_v18.md,">Valores posibles: Pruebas de Acceso, COU sin PAU, FP, Titulados Universitarios, Mayores de 25, Mayo
de 40, Mayores de 45

## DIMENSION: Fecha de actualización ##

Notas generales:
- Indica la fecha de la última recarga de datos.",sentence,229,51,6033,6262
info_cubo_ofertaplazas_v18.md,"Habitualmente es el domingo anterior a la consulta de dato

## DIMENSION: Prelación Convo Nota de Corte ##

Notas generales:
- Indica si la nota de corte corresponde a un solicitante del cupo general de la convocatoria ordinaria o años anteriores (J), o bien de la convocatoria de extraordinaria (S).",sentence,300,60,6264,6564
info_cubo_ofertaplazas_v18.md,"Observaciones:

>Esta variable es imprescindible para entender las notas de corte del cupo general en la convocato
extraordinaria, puesto que los solicitantes de esta vía que superaron la prueba de acceso en la convocato ordinaria o en años anteriores tienen siempre preferencia sobre los que superan la prueba de acceso en convocatoria extraordinaria, independientemente de su nota de admisión.",sentence,395,64,6565,6960
info_cubo_ofertaplazas_v18.md,>IMPORTANTE: la prioridad ha dejado de tener vigencia a partir del curso académico 2017/18.,sentence,91,17,6961,7052
info_cubo_ofertaplazas_v18.md,"## DIMENSION: Tipo de Acceso ##

Notas generales:
- Clasifica las plazas según se correspondan con el proceso general de preinscripción a grados (Preinscripció o con el proceso de admisión a máster (acceso a ciclos).",sentence,216,43,7054,7270
info_cubo_ofertaplazas_v18.md,"## DIMENSION: Titulación ##

Atributos:
• Estudio:
Permite identificar el estudio ofertado.",sentence,91,18,7272,7363
info_cubo_ofertaplazas_v18.md,"• Plan de estudios:
Permite identificar el plan de estudios ofertado.",sentence,69,13,7365,7434
info_cubo_ofertaplazas_v18.md,"• Rama de Conocimiento:
Permite identificar la rama de conocimiento (Artes y Humanidades, Ciencias, Ciencias Sociales y Jurídic Ciencias de la Salud, Ingeniería y Arquitectura) a la que se asigna el plan de estudios ofertado.",sentence,225,42,7436,7661
info_cubo_ofertaplazas_v18.md,"• Tipo de estudio:
Permite identificar el tipo de titulación ofertada: grado, licenciatura o equivalente, diplomatura equivalente.",sentence,130,22,7663,7793
info_cubo_PDI_v21.md,"=== MEDIDAS ===

** Número de PDI **
Número de efectivos de PDI que constan en las bases de datos de personal con contrato activo a la fecha de consulta. Observaciones:

>IMPORTANTE: se debe utilizar la dimensión TIEMPO (año o mes) para filtrar el número de efectivos en un
periodo o fecha concreta. Se incluye la totalidad de efectivos, estén ocupando o no su puesto.",section,369,76,0,369
info_cubo_PDI_v21.md,=== DIMENSIONES ===,section,20,3,370,390
info_cubo_PDI_v21.md,"## DIMENSION: Compatibilidad ##

Atributos:
• Concedida (S/N):
Permite clasificar los datos en función de si el personal tiene concedida (S) o no (N), por esta institución, compatibilidad con otras actividades públicas o privadas.",section,231,48,391,622
info_cubo_PDI_v21.md,"## DIMENSION: Contrato ##

Atributos:
• Asociado Sanitario (S/N):
Permite distinguir a los profesores asociados de ciencias de la salud (S) del resto del personal (N).

• Carga Docente Semanal:
Permite clasificar al personal en función del número horas semanales que conlleva su carga docente.

• Categoría Cuerpo Escala:
Permite clasificar los datos en función de la categoría/cuerpo/escala a la que pertenece el personal.

>Valores posibles: Catedráticos de Universidad, Titulares de Universidad, Catedráticos de Escuelas
Universitarias, Titulares de Escuelas Universitarias, Asociados, Contratados Doctores, Personal Investigador Formación, Personal Docente Investigador o Técnico, Ayudantes Doctores, Colaboradores, Colaboradores Extraordinarios, Eméritos, etc.

• Dedicación:
Identifica el tipo de dedicación que tiene el personal.

>Valores posibles: tiempo completo, tiempo parcial, tiempo parcial 6 horas, tiempo parcial 4 horas, tiempo
parcial 3 horas, conjunta completa (es la dedicación de algunos profesores vinculados a instituciones sanitar distintos de los asociados de ciencias de la salud), conjunta parcial (es la dedicación de los asociados de cien de la salud), colaborador extraordinario.

• Permanente (S/N):
Permite agrupar los datos en función de si el personal tiene vinculación permanente con la Universidad Zaragoza (S) o no (N). Según la disposición adicional décima de los Estatutos de la UZ, “son profesores con vinculación permanente Universidad los funcionarios de los cuerpos docentes universitarios y los profesores contratados con cará indefinido"". Por tanto se consideran permanentes: • Funcionarios de los cuerpos docentes universitarios: catedráticos de universidad, profesores titulare universidad, catedráticos de escuelas universitarias y profesores titulares de escuelas universitarias. • Profesores contratados con carácter indefinido: los que tienen régimen jurídico ""laboral"" y contrato con modalidades ""indefinido fijo"" o ""indefinido no fijo"".

• Régimen Jurídico:
Permite agrupar al personal en función del régimen jurídico en el que se adscribe su nombramiento o contra

>Valores posibles: funcionario, laboral, atípico (es el caso de los colaboradores extraordinarios y el de los
eméritos), contratado administrativo.

• Situación Administrativa:
Permite agrupar el personal en función de la situación administrativa en la que se encuentre.

>Ejemplos: servicio activo, excedencia, suspensión de contrato, servicios especiales.

• Tipo personal:
Permite agrupar el personal en función de la modalidad de régimen jurídico.

>Valores posibles: de carrera, indefinido fijo, temporal, convencional (es el caso de los colaboradores
extraordinarios y el de los eméritos).",section,2715,469,623,3338
info_cubo_PDI_v21.md,"## DIMENSION: Fecha de actualización ##

Notas generales:
- Indica la fecha de la última recarga de datos. Habitualmente es el domingo anterior a la consulta de datos.",section,168,34,3339,3507
info_cubo_PDI_v21.md,"## DIMENSION: Persona ##

Atributos:
• Edad:
Permite agrupar el personal en función de su edad a fecha 31 de diciembre del año seleccionado.

>Valores posibles: 21-25, 26-30, 31-35, 36-40, 41-45, 46-50, 51-55, 56-60,61-65, >65.

• País Nacionalidad:
Permite clasificar los datos en función del país de nacionalidad legal del personal.

• Sexo:
Permite clasificar el personal en función de su sexo.",section,398,84,3508,3906
info_cubo_PDI_v21.md,"## DIMENSION: Puesto ##

Atributos:
• Centro:
Permite clasificar los datos en función del centro al que pertenece el personal.

• Centro Localidad:
Permite clasificar los datos en función de la localidad donde se sitúa el centro al que está adscrito el persona

• Departamento:
Permite clasificar los datos en función del departamento al que está adscrito el personal.

• Macroárea:
Permite clasificar los datos en función de la macroárea a la que se asigna el área de conocimiento de adscripción del personal, según lo dispuesto en el Anexo I del Real Decreto 415/2015, de 29 de mayo, por el que se modifica el Real Decreto 1312/2007, de 5 de octubre, por el que se establece la acreditación nacional para el acceso a los cuerpos docentes universitarios.

• Área:
Permite clasificar los datos en función del área de conocimiento a la que pertenece el personal.",section,862,163,3907,4769
info_cubo_PDI_v21.md,"## DIMENSION: Sindicato ##

Notas generales:
- Permite clasificar el personal en función de si tiene concedida o no algún tipo de reducción horaria para el desempeño de tareas sindicales.

>Nota: si los efectivos tienen concedida reducción se detalla la denominación del sindicato y si no tienen
concedida reducción figura el valor “No Informado”.

Atributos:
• Reducción:
Identifica el porcentaje de reducción horaria o número de horas lectivas que se reducen por el desempeño d tareas sindicales.

>Nota: si el empleado no tiene concedida reducción horaria, figura con el valor “Sin reducción”.",section,597,111,4770,5367
info_cubo_PDI_v21.md,"## DIMENSION: TIEMPO ##

Notas generales:
- Permite ubicar en el tiempo la relación del personal con la UZ. Se pueden desglosar los datos según el año o mes: • MES: se incluyen los efectivos existentes a fecha último día del mes seleccionado (si se trata de un m en curso, se incluyen los efectivos existentes a la fecha de la última carga). • AÑO: se acumulan los efectivos existentes a fecha último día de todos los meses del año seleccionad (si el año seleccionado es un año en curso, se acumulan los efectivos existentes a fecha último día d los meses anteriores y para el mes en curso los efectivos existentes a la fecha de la última carga).",section,647,135,5368,6015
info_cubo_PDI_v21.md,"## DIMENSION: Titulación ##

Notas generales:
- Permite clasificar los datos en función del nivel de titulación del personal.

>Valores posibles: SUP (licenciatura o equivalente), MED (diplomatura o equivalente), DOC (doctor), MAS
(máster), GRA (grado), ELE (elemental), BAC (bachillerato).

Atributos:
• Doctor (S/N):
Permite clasificar el personal en función de si figura como Doctor en las bases de datos de personal (S) o no

• Doctor País:
Permite clasificar el personal en función, en su caso, del país en que ha obtenido el título de Doctor.

>Nota: en caso de que no conste que el efectivo haya obtenido el título de Doctor se consignará ""No aplica"".

• Doctor Universidad:
Permite clasificar el personal en función, en su caso, de la universidad en que ha obtenido el título de Doctor

>Nota: en caso de que no conste que el efectivo haya obtenido el título de Doctor se consignará ""No aplica"".",section,904,200,6016,6920
info_cubo_PDI_v21.md,"## DIMENSION: Tramos ##

Atributos:
• Docencia Quinquenios:
Permite clasificar los datos en función del número de quinquenios o tramos de docencia que tiene reconocid el personal a efectos económicos.

>Nota: contabiliza los quinquenios acumulados por el efectivo en la fecha (año o mes) seleccionada en la
dimensión “tiempo”.

• Gestión Trienios:
Permite clasificar los datos en función del número de trienios o tramos de gestión que tiene reconocido el personal.

>Nota: contabiliza los trienios acumulados por el efectivo en la fecha (año o mes) seleccionada en la dimensi
“tiempo”.

• Investigación Estatal:
Permite clasificar los datos en función del número de sexenios o tramos de investigación reconocidos por la CNEAI, tanto para los cuerpos de funcionarios docentes universitarios como para el personal contratado.

>Nota: contabiliza los sexenios reconocidos a efectos económicos acumulados en la fecha (año o mes)
seleccionada en la dimensión “tiempo”.",section,965,176,6921,7886
info_cubo_PDI_v21.md,=== MEDIDAS ===,paragraph,15,3,0,15
info_cubo_PDI_v21.md,"** Número de PDI **
Número de efectivos de PDI que constan en las bases de datos de personal con contrato activo a la fecha de consulta. Observaciones:",paragraph,151,32,17,168
info_cubo_PDI_v21.md,">IMPORTANTE: se debe utilizar la dimensión TIEMPO (año o mes) para filtrar el número de efectivos en un
periodo o fecha concreta. Se incluye la totalidad de efectivos, estén ocupando o no su puesto.",paragraph,198,41,170,368
info_cubo_PDI_v21.md,=== DIMENSIONES ===,paragraph,19,3,370,389
info_cubo_PDI_v21.md,## DIMENSION: Compatibilidad ##,paragraph,31,7,391,422
info_cubo_PDI_v21.md,"Atributos:
• Concedida (S/N):
Permite clasificar los datos en función de si el personal tiene concedida (S) o no (N), por esta institución, compatibilidad con otras actividades públicas o privadas.",paragraph,197,41,424,621
info_cubo_PDI_v21.md,## DIMENSION: Contrato ##,paragraph,25,7,623,648
info_cubo_PDI_v21.md,"Atributos:
• Asociado Sanitario (S/N):
Permite distinguir a los profesores asociados de ciencias de la salud (S) del resto del personal (N).",paragraph,140,31,650,790
info_cubo_PDI_v21.md,"• Carga Docente Semanal:
Permite clasificar al personal en función del número horas semanales que conlleva su carga docente.",paragraph,124,21,792,916
info_cubo_PDI_v21.md,"• Categoría Cuerpo Escala:
Permite clasificar los datos en función de la categoría/cuerpo/escala a la que pertenece el personal.",paragraph,128,21,918,1046
info_cubo_PDI_v21.md,">Valores posibles: Catedráticos de Universidad, Titulares de Universidad, Catedráticos de Escuelas
Universitarias, Titulares de Escuelas Universitarias, Asociados, Contratados Doctores, Personal Investigador Formación, Personal Docente Investigador o Técnico, Ayudantes Doctores, Colaboradores, Colaboradores Extraordinarios, Eméritos, etc.",paragraph,340,49,1048,1388
info_cubo_PDI_v21.md,"• Dedicación:
Identifica el tipo de dedicación que tiene el personal.",paragraph,69,13,1390,1459
info_cubo_PDI_v21.md,">Valores posibles: tiempo completo, tiempo parcial, tiempo parcial 6 horas, tiempo parcial 4 horas, tiempo
parcial 3 horas, conjunta completa (es la dedicación de algunos profesores vinculados a instituciones sanitar distintos de los asociados de ciencias de la salud), conjunta parcial (es la dedicación de los asociados de cien de la salud), colaborador extraordinario.",paragraph,371,68,1461,1832
info_cubo_PDI_v21.md,"• Permanente (S/N):
Permite agrupar los datos en función de si el personal tiene vinculación permanente con la Universidad Zaragoza (S) o no (N). Según la disposición adicional décima de los Estatutos de la UZ, “son profesores con vinculación permanente Universidad los funcionarios de los cuerpos docentes universitarios y los profesores contratados con cará indefinido"". Por tanto se consideran permanentes: • Funcionarios de los cuerpos docentes universitarios: catedráticos de universidad, profesores titulare universidad, catedráticos de escuelas universitarias y profesores titulares de escuelas universitarias. • Profesores contratados con carácter indefinido: los que tienen régimen jurídico ""laboral"" y contrato con modalidades ""indefinido fijo"" o ""indefinido no fijo"".",paragraph,778,130,1834,2612
info_cubo_PDI_v21.md,"• Régimen Jurídico:
Permite agrupar al personal en función del régimen jurídico en el que se adscribe su nombramiento o contra",paragraph,126,22,2614,2740
info_cubo_PDI_v21.md,">Valores posibles: funcionario, laboral, atípico (es el caso de los colaboradores extraordinarios y el de los
eméritos), contratado administrativo.",paragraph,147,27,2742,2889
info_cubo_PDI_v21.md,"• Situación Administrativa:
Permite agrupar el personal en función de la situación administrativa en la que se encuentre.",paragraph,121,20,2891,3012
info_cubo_PDI_v21.md,">Ejemplos: servicio activo, excedencia, suspensión de contrato, servicios especiales.",paragraph,85,15,3014,3099
info_cubo_PDI_v21.md,"• Tipo personal:
Permite agrupar el personal en función de la modalidad de régimen jurídico.",paragraph,92,17,3101,3193
info_cubo_PDI_v21.md,">Valores posibles: de carrera, indefinido fijo, temporal, convencional (es el caso de los colaboradores
extraordinarios y el de los eméritos).",paragraph,142,28,3195,3337
info_cubo_PDI_v21.md,## DIMENSION: Fecha de actualización ##,paragraph,39,9,3339,3378
info_cubo_PDI_v21.md,"Notas generales:
- Indica la fecha de la última recarga de datos. Habitualmente es el domingo anterior a la consulta de datos.",paragraph,126,25,3380,3506
info_cubo_PDI_v21.md,## DIMENSION: Persona ##,paragraph,24,7,3508,3532
info_cubo_PDI_v21.md,"Atributos:
• Edad:
Permite agrupar el personal en función de su edad a fecha 31 de diciembre del año seleccionado.",paragraph,114,23,3534,3648
info_cubo_PDI_v21.md,">Valores posibles: 21-25, 26-30, 31-35, 36-40, 41-45, 46-50, 51-55, 56-60,61-65, >65.",paragraph,85,23,3650,3735
info_cubo_PDI_v21.md,"• País Nacionalidad:
Permite clasificar los datos en función del país de nacionalidad legal del personal.",paragraph,105,18,3737,3842
info_cubo_PDI_v21.md,"• Sexo:
Permite clasificar el personal en función de su sexo.",paragraph,61,13,3844,3905
info_cubo_PDI_v21.md,## DIMENSION: Puesto ##,paragraph,23,7,3907,3930
info_cubo_PDI_v21.md,"Atributos:
• Centro:
Permite clasificar los datos en función del centro al que pertenece el personal.",paragraph,101,19,3932,4033
info_cubo_PDI_v21.md,"• Centro Localidad:
Permite clasificar los datos en función de la localidad donde se sitúa el centro al que está adscrito el persona",paragraph,132,24,4035,4167
info_cubo_PDI_v21.md,"• Departamento:
Permite clasificar los datos en función del departamento al que está adscrito el personal.",paragraph,106,18,4169,4275
info_cubo_PDI_v21.md,"• Macroárea:
Permite clasificar los datos en función de la macroárea a la que se asigna el área de conocimiento de adscripción del personal, según lo dispuesto en el Anexo I del Real Decreto 415/2015, de 29 de mayo, por el que se modifica el Real Decreto 1312/2007, de 5 de octubre, por el que se establece la acreditación nacional para el acceso a los cuerpos docentes universitarios.",paragraph,385,75,4277,4662
info_cubo_PDI_v21.md,"• Área:
Permite clasificar los datos en función del área de conocimiento a la que pertenece el personal.",paragraph,104,20,4664,4768
info_cubo_PDI_v21.md,## DIMENSION: Sindicato ##,paragraph,26,7,4770,4796
info_cubo_PDI_v21.md,"Notas generales:
- Permite clasificar el personal en función de si tiene concedida o no algún tipo de reducción horaria para el desempeño de tareas sindicales.",paragraph,159,28,4798,4957
info_cubo_PDI_v21.md,">Nota: si los efectivos tienen concedida reducción se detalla la denominación del sindicato y si no tienen
concedida reducción figura el valor “No Informado”.",paragraph,158,29,4959,5117
info_cubo_PDI_v21.md,"Atributos:
• Reducción:
Identifica el porcentaje de reducción horaria o número de horas lectivas que se reducen por el desempeño d tareas sindicales.",paragraph,149,26,5119,5268
info_cubo_PDI_v21.md,">Nota: si el empleado no tiene concedida reducción horaria, figura con el valor “Sin reducción”.",paragraph,96,21,5270,5366
info_cubo_PDI_v21.md,## DIMENSION: TIEMPO ##,paragraph,23,7,5368,5391
info_cubo_PDI_v21.md,"Notas generales:
- Permite ubicar en el tiempo la relación del personal con la UZ. Se pueden desglosar los datos según el año o mes: • MES: se incluyen los efectivos existentes a fecha último día del mes seleccionado (si se trata de un m en curso, se incluyen los efectivos existentes a la fecha de la última carga). • AÑO: se acumulan los efectivos existentes a fecha último día de todos los meses del año seleccionad (si el año seleccionado es un año en curso, se acumulan los efectivos existentes a fecha último día d los meses anteriores y para el mes en curso los efectivos existentes a la fecha de la última carga).",paragraph,621,128,5393,6014
info_cubo_PDI_v21.md,## DIMENSION: Titulación ##,paragraph,27,7,6016,6043
info_cubo_PDI_v21.md,"Notas generales:
- Permite clasificar los datos en función del nivel de titulación del personal.",paragraph,96,17,6045,6141
info_cubo_PDI_v21.md,">Valores posibles: SUP (licenciatura o equivalente), MED (diplomatura o equivalente), DOC (doctor), MAS
(máster), GRA (grado), ELE (elemental), BAC (bachillerato).",paragraph,163,43,6143,6306
info_cubo_PDI_v21.md,"Atributos:
• Doctor (S/N):
Permite clasificar el personal en función de si figura como Doctor en las bases de datos de personal (S) o no",paragraph,136,31,6308,6444
info_cubo_PDI_v21.md,"• Doctor País:
Permite clasificar el personal en función, en su caso, del país en que ha obtenido el título de Doctor.",paragraph,118,26,6446,6564
info_cubo_PDI_v21.md,">Nota: en caso de que no conste que el efectivo haya obtenido el título de Doctor se consignará ""No aplica"".",paragraph,108,25,6566,6674
info_cubo_PDI_v21.md,"• Doctor Universidad:
Permite clasificar el personal en función, en su caso, de la universidad en que ha obtenido el título de Doctor",paragraph,133,26,6676,6809
info_cubo_PDI_v21.md,">Nota: en caso de que no conste que el efectivo haya obtenido el título de Doctor se consignará ""No aplica"".",paragraph,108,25,6811,6919
info_cubo_PDI_v21.md,## DIMENSION: Tramos ##,paragraph,23,7,6921,6944
info_cubo_PDI_v21.md,"Atributos:
• Docencia Quinquenios:
Permite clasificar los datos en función del número de quinquenios o tramos de docencia que tiene reconocid el personal a efectos económicos.",paragraph,175,29,6946,7121
info_cubo_PDI_v21.md,">Nota: contabiliza los quinquenios acumulados por el efectivo en la fecha (año o mes) seleccionada en la
dimensión “tiempo”.",paragraph,124,26,7123,7247
info_cubo_PDI_v21.md,"• Gestión Trienios:
Permite clasificar los datos en función del número de trienios o tramos de gestión que tiene reconocido el personal.",paragraph,136,24,7249,7385
info_cubo_PDI_v21.md,">Nota: contabiliza los trienios acumulados por el efectivo en la fecha (año o mes) seleccionada en la dimensi
“tiempo”.",paragraph,119,26,7387,7506
info_cubo_PDI_v21.md,"• Investigación Estatal:
Permite clasificar los datos en función del número de sexenios o tramos de investigación reconocidos por la CNEAI, tanto para los cuerpos de funcionarios docentes universitarios como para el personal contratado.",paragraph,236,37,7508,7744
info_cubo_PDI_v21.md,">Nota: contabiliza los sexenios reconocidos a efectos económicos acumulados en la fecha (año o mes)
seleccionada en la dimensión “tiempo”.",paragraph,138,27,7746,7884
info_cubo_PDI_v21.md,"=== MEDIDAS ===

** Número de PDI **
Número de efectivos de PDI que constan en las bases de datos de personal con contrato activo a la fecha de consulta.",sentence,153,33,0,153
info_cubo_PDI_v21.md,"Observaciones:

>IMPORTANTE: se debe utilizar la dimensión TIEMPO (año o mes) para filtrar el número de efectivos en un
periodo o fecha concreta.",sentence,145,29,153,298
info_cubo_PDI_v21.md,"Se incluye la totalidad de efectivos, estén ocupando o no su puesto.",sentence,68,14,299,367
info_cubo_PDI_v21.md,"=== DIMENSIONES ===

## DIMENSION: Compatibilidad ##

Atributos:
• Concedida (S/N):
Permite clasificar los datos en función de si el personal tiene concedida (S) o no (N), por esta institución, compatibilidad con otras actividades públicas o privadas.",sentence,251,51,368,619
info_cubo_PDI_v21.md,"## DIMENSION: Contrato ##

Atributos:
• Asociado Sanitario (S/N):
Permite distinguir a los profesores asociados de ciencias de la salud (S) del resto del personal (N).",sentence,167,38,621,788
info_cubo_PDI_v21.md,"• Carga Docente Semanal:
Permite clasificar al personal en función del número horas semanales que conlleva su carga docente.",sentence,124,21,790,914
info_cubo_PDI_v21.md,"• Categoría Cuerpo Escala:
Permite clasificar los datos en función de la categoría/cuerpo/escala a la que pertenece el personal.",sentence,128,21,916,1044
info_cubo_PDI_v21.md,">Valores posibles: Catedráticos de Universidad, Titulares de Universidad, Catedráticos de Escuelas
Universitarias, Titulares de Escuelas Universitarias, Asociados, Contratados Doctores, Personal Investigador Formación, Personal Docente Investigador o Técnico, Ayudantes Doctores, Colaboradores, Colaboradores Extraordinarios, Eméritos, etc.",sentence,340,49,1046,1386
info_cubo_PDI_v21.md,"• Dedicación:
Identifica el tipo de dedicación que tiene el personal.",sentence,69,13,1388,1457
info_cubo_PDI_v21.md,">Valores posibles: tiempo completo, tiempo parcial, tiempo parcial 6 horas, tiempo parcial 4 horas, tiempo
parcial 3 horas, conjunta completa (es la dedicación de algunos profesores vinculados a instituciones sanitar distintos de los asociados de ciencias de la salud), conjunta parcial (es la dedicación de los asociados de cien de la salud), colaborador extraordinario.",sentence,371,68,1459,1830
info_cubo_PDI_v21.md,"• Permanente (S/N):
Permite agrupar los datos en función de si el personal tiene vinculación permanente con la Universidad Zaragoza (S) o no (N).",sentence,145,32,1832,1977
info_cubo_PDI_v21.md,"Según la disposición adicional décima de los Estatutos de la UZ, “son profesores con vinculación permanente Universidad los funcionarios de los cuerpos docentes universitarios y los profesores contratados con cará indefinido"".",sentence,226,35,1979,2205
info_cubo_PDI_v21.md,"Por tanto se consideran permanentes: • Funcionarios de los cuerpos docentes universitarios: catedráticos de universidad, profesores titulare universidad, catedráticos de escuelas universitarias y profesores titulares de escuelas universitarias.",sentence,244,33,2206,2450
info_cubo_PDI_v21.md,"• Profesores contratados con carácter indefinido: los que tienen régimen jurídico ""laboral"" y contrato con modalidades ""indefinido fijo"" o ""indefinido no fijo"".",sentence,160,30,2451,2611
info_cubo_PDI_v21.md,"• Régimen Jurídico:
Permite agrupar al personal en función del régimen jurídico en el que se adscribe su nombramiento o contra

>Valores posibles: funcionario, laboral, atípico (es el caso de los colaboradores extraordinarios y el de los
eméritos), contratado administrativo.",sentence,275,49,2612,2887
info_cubo_PDI_v21.md,"• Situación Administrativa:
Permite agrupar el personal en función de la situación administrativa en la que se encuentre.",sentence,121,20,2889,3010
info_cubo_PDI_v21.md,">Ejemplos: servicio activo, excedencia, suspensión de contrato, servicios especiales.",sentence,85,15,3012,3097
info_cubo_PDI_v21.md,"• Tipo personal:
Permite agrupar el personal en función de la modalidad de régimen jurídico.",sentence,92,17,3099,3191
info_cubo_PDI_v21.md,">Valores posibles: de carrera, indefinido fijo, temporal, convencional (es el caso de los colaboradores
extraordinarios y el de los eméritos).",sentence,142,28,3193,3335
info_cubo_PDI_v21.md,"## DIMENSION: Fecha de actualización ##

Notas generales:
- Indica la fecha de la última recarga de datos.",sentence,106,23,3337,3443
info_cubo_PDI_v21.md,Habitualmente es el domingo anterior a la consulta de datos.,sentence,60,11,3445,3505
info_cubo_PDI_v21.md,"## DIMENSION: Persona ##

Atributos:
• Edad:
Permite agrupar el personal en función de su edad a fecha 31 de diciembre del año seleccionado.",sentence,140,30,3506,3646
info_cubo_PDI_v21.md,">Valores posibles: 21-25, 26-30, 31-35, 36-40, 41-45, 46-50, 51-55, 56-60,61-65, >65.",sentence,85,23,3648,3733
info_cubo_PDI_v21.md,"• País Nacionalidad:
Permite clasificar los datos en función del país de nacionalidad legal del personal.",sentence,105,18,3735,3840
info_cubo_PDI_v21.md,"• Sexo:
Permite clasificar el personal en función de su sexo.",sentence,61,13,3842,3903
info_cubo_PDI_v21.md,"## DIMENSION: Puesto ##

Atributos:
• Centro:
Permite clasificar los datos en función del centro al que pertenece el personal.",sentence,126,26,3905,4031
info_cubo_PDI_v21.md,"• Centro Localidad:
Permite clasificar los datos en función de la localidad donde se sitúa el centro al que está adscrito el persona

• Departamento:
Permite clasificar los datos en función del departamento al que está adscrito el personal.",sentence,240,42,4033,4273
info_cubo_PDI_v21.md,"• Macroárea:
Permite clasificar los datos en función de la macroárea a la que se asigna el área de conocimiento de adscripción del personal, según lo dispuesto en el Anexo I del Real Decreto 415/2015, de 29 de mayo, por el que se modifica el Real Decreto 1312/2007, de 5 de octubre, por el que se establece la acreditación nacional para el acceso a los cuerpos docentes universitarios.",sentence,385,75,4275,4660
info_cubo_PDI_v21.md,"• Área:
Permite clasificar los datos en función del área de conocimiento a la que pertenece el personal.",sentence,104,20,4662,4766
info_cubo_PDI_v21.md,"## DIMENSION: Sindicato ##

Notas generales:
- Permite clasificar el personal en función de si tiene concedida o no algún tipo de reducción horaria para el desempeño de tareas sindicales.",sentence,187,35,4768,4955
info_cubo_PDI_v21.md,">Nota: si los efectivos tienen concedida reducción se detalla la denominación del sindicato y si no tienen
concedida reducción figura el valor “No Informado”.",sentence,158,29,4957,5115
info_cubo_PDI_v21.md,"Atributos:
• Reducción:
Identifica el porcentaje de reducción horaria o número de horas lectivas que se reducen por el desempeño d tareas sindicales.",sentence,149,26,5117,5266
info_cubo_PDI_v21.md,">Nota: si el empleado no tiene concedida reducción horaria, figura con el valor “Sin reducción”.",sentence,96,21,5268,5364
info_cubo_PDI_v21.md,"## DIMENSION: TIEMPO ##

Notas generales:
- Permite ubicar en el tiempo la relación del personal con la UZ.",sentence,107,24,5366,5473
info_cubo_PDI_v21.md,"Se pueden desglosar los datos según el año o mes: • MES: se incluyen los efectivos existentes a fecha último día del mes seleccionado (si se trata de un m en curso, se incluyen los efectivos existentes a la fecha de la última carga).",sentence,233,50,5475,5708
info_cubo_PDI_v21.md,"• AÑO: se acumulan los efectivos existentes a fecha último día de todos los meses del año seleccionad (si el año seleccionado es un año en curso, se acumulan los efectivos existentes a fecha último día d los meses anteriores y para el mes en curso los efectivos existentes a la fecha de la última carga).",sentence,304,61,5709,6013
info_cubo_PDI_v21.md,"## DIMENSION: Titulación ##

Notas generales:
- Permite clasificar los datos en función del nivel de titulación del personal.",sentence,125,24,6014,6139
info_cubo_PDI_v21.md,">Valores posibles: SUP (licenciatura o equivalente), MED (diplomatura o equivalente), DOC (doctor), MAS
(máster), GRA (grado), ELE (elemental), BAC (bachillerato).",sentence,163,43,6141,6304
info_cubo_PDI_v21.md,"Atributos:
• Doctor (S/N):
Permite clasificar el personal en función de si figura como Doctor en las bases de datos de personal (S) o no

• Doctor País:
Permite clasificar el personal en función, en su caso, del país en que ha obtenido el título de Doctor.",sentence,256,57,6306,6562
info_cubo_PDI_v21.md,">Nota: en caso de que no conste que el efectivo haya obtenido el título de Doctor se consignará ""No aplica"".",sentence,108,25,6564,6672
info_cubo_PDI_v21.md,"• Doctor Universidad:
Permite clasificar el personal en función, en su caso, de la universidad en que ha obtenido el título de Doctor

>Nota: en caso de que no conste que el efectivo haya obtenido el título de Doctor se consignará ""No aplica"".",sentence,243,51,6674,6917
info_cubo_PDI_v21.md,"## DIMENSION: Tramos ##

Atributos:
• Docencia Quinquenios:
Permite clasificar los datos en función del número de quinquenios o tramos de docencia que tiene reconocid el personal a efectos económicos.",sentence,200,36,6919,7119
info_cubo_PDI_v21.md,">Nota: contabiliza los quinquenios acumulados por el efectivo en la fecha (año o mes) seleccionada en la
dimensión “tiempo”.",sentence,124,26,7121,7245
info_cubo_PDI_v21.md,"• Gestión Trienios:
Permite clasificar los datos en función del número de trienios o tramos de gestión que tiene reconocido el personal.",sentence,136,24,7247,7383
info_cubo_PDI_v21.md,">Nota: contabiliza los trienios acumulados por el efectivo en la fecha (año o mes) seleccionada en la dimensi
“tiempo”.",sentence,119,26,7385,7504
info_cubo_PDI_v21.md,"• Investigación Estatal:
Permite clasificar los datos en función del número de sexenios o tramos de investigación reconocidos por la CNEAI, tanto para los cuerpos de funcionarios docentes universitarios como para el personal contratado.",sentence,236,37,7506,7742
info_cubo_PDI_v21.md,">Nota: contabiliza los sexenios reconocidos a efectos económicos acumulados en la fecha (año o mes)
seleccionada en la dimensión “tiempo”.",sentence,138,27,7744,7882
info_cubo_produccionCientifica_v13.md,"=== MEDIDAS ===

** Número de autores **
Número de investigadores que cumplen en el periodo seleccionado alguna de las siguientes condiciones: • Son autores de al menos un artículo publicado. • Son autores de al menos un libro o capítulo de libro publicado. • Tienen presencia en al menos un congreso celebrado, ya sea a nivel organizativo (en el comité científ y organizador) o participativo (ponencia, póster u otros).

>Se recomienda incorporar a la consulta la dimensión 'AÑO' para que se muestren los datos por año. De lo
contrario se acumularán todos los artículos desde que existen datos.

** Artículos **
Número de artículos publicados.

>Se recomienda incorporar a la consulta la dimensión 'AÑO' para que se muestren los datos por año. De lo
contrario se acumularán todos los artículos desde que existen datos.

** Capítulos de libro **
Número de capítulos de libro publicados.

>Se recomienda incorporar a la consulta la dimensión 'AÑO' para que se muestren los datos por año. De lo
contrario se acumularán todos los capítulos de libro desde que existen datos.

** Libros **
Número de libros publicados.

>Se recomienda incorporar a la consulta la dimensión 'AÑO' para que se muestren los datos por año. De lo
contrario se acumularán todos los libros desde que existen datos.

** Actividades en congresos **
Número de actividades realizadas en congresos.

>Se recomienda incorporar a la consulta la dimensión 'AÑO' para que se muestren los datos por año. De lo
contrario se acumularán todas las actividades en congresos desde que existen datos.",section,1555,299,0,1555
info_cubo_produccionCientifica_v13.md,=== DIMENSIONES ===,section,20,3,1556,1576
info_cubo_produccionCientifica_v13.md,"## DIMENSION: Autor ##

Atributos:
• Centro:
Permite clasificar los datos en función del centro al que pertenecen los autores.

• Departamento:
Permite clasificar los datos en función del departamento al que están adscritos los autores.

• Edad:
Permite agrupar los rangos de edad de los autores en función de su fecha de nacimiento.

>Valores posibles: 20 años o menos, 21 a 30, 31 a 40, 41 a 50, 51 a 60, 60 años o más.

• Grupo de investigación:
Permite clasificar los datos en función del grupo de investigación al que pertenecen los autores.

• Instituto de investigación:
Permite clasificar los datos en función del instituto universitario de investigación al que pertenecen los autor

• Macroárea:
Permite clasificar los datos en función de la macroárea a la que pertenecen los autores.

>Valores posibles: Artes y Humanidades, Ciencias, Ciencias Sociales y Jurídicas, Ciencias de la Salud, Ingenierí
Arquitectura.

• Nacionalidad:
Permite clasificar los datos en función de la nacionalidad legal de los autores.

• Otros Centros de Investigación:
Permite clasificar los datos en función de si el autor pertenece a otros centros de investigación distintos de lo institutos universitarios de investigación. Ejemplo: INSTITUTO INVESTIGACIÓN SANITARIA DE ARAGÓN (IIS).

• Sexo:
Permite agrupar a los autores en función de su sexo.

• Área de conocimiento del autor:
Permite clasificar los datos en función del área de conocimiento a la que están adscritos los autores.",section,1473,275,1577,3050
info_cubo_produccionCientifica_v13.md,"## DIMENSION: AÑO ##

Notas generales:
- Permite clasificar la producción científica en función del año de su publicación o celebración).",section,138,27,3051,3189
info_cubo_produccionCientifica_v13.md,"## DIMENSION: Congreso ##

Atributos:
• Categoría:
Permite clasificar las actividades en congresos en función de su categoría. Observaciones:

>Se recomienda cruzar esta variable sólo con la medida ""actividades en congresos"".
>Valores posibles: A+, A, B, C, no clasificado.

• País:
Permite clasificar las actividades en congresos en función del país en que tienen lugar.

>Nota: sólo tiene sentido cruzar esta variable con la medida ""actividades en congresos"".

• Tipo de actividad:
Permite clasificar las actividades en congresos en función del tipo de participación. Observaciones:

>Sólo tiene sentido cruzar esta variable con la medida ""actividades en congresos"".
>Valores posibles: ponencia invitada, ponencia, póster, comité organizador, comité científico, otros.

• Ámbito geográfico:
Permite clasificar las actividades en congresos en función de su ámbito. Observaciones:

>Sólo tiene sentido cruzar esta variable con la medida ""actividades en congresos"".
>Valores posibles: autonómica, nacional, Unión Europea, internacional no UE, otros.",section,1049,199,3190,4239
info_cubo_produccionCientifica_v13.md,"## DIMENSION: Fecha de actualización ##

Notas generales:
- Indica la fecha de la última recarga de datos. Habitualmente es el domingo anterior a la consulta de datos.",section,168,34,4240,4408
info_cubo_produccionCientifica_v13.md,"## DIMENSION: Publicación ##

Atributos:
• Artículo en Abierto (S/N):
Permite diferenciar los artículos que están publicados en abierto (S) de los que no lo están (N).

> Sólo tiene sentido cruzar esta variable con la medida ""artículos"".

• Idioma:
Permite clasificar los artículos, revistas editadas, capítulos de libros y libros en función del idioma en que está publicados.

>Nota: esta dimensión no está informada en la medida ""actividades en congresos"".

• Tipo de artículo:
Permite clasificar los artículos en función de su tipología. Observaciones:

>Se recomienda cruzar esta variable sólo con la medida ""artículos"".
>Valores posibles: artículo científico, revisión, editorial, carta, texto académico, comunicación, ensayo clínico
corrección, reseña.",section,760,150,4409,5169
info_cubo_produccionCientifica_v13.md,=== MEDIDAS ===,paragraph,15,3,0,15
info_cubo_produccionCientifica_v13.md,"** Número de autores **
Número de investigadores que cumplen en el periodo seleccionado alguna de las siguientes condiciones: • Son autores de al menos un artículo publicado. • Son autores de al menos un libro o capítulo de libro publicado. • Tienen presencia en al menos un congreso celebrado, ya sea a nivel organizativo (en el comité científ y organizador) o participativo (ponencia, póster u otros).",paragraph,403,79,17,420
info_cubo_produccionCientifica_v13.md,">Se recomienda incorporar a la consulta la dimensión 'AÑO' para que se muestren los datos por año. De lo
contrario se acumularán todos los artículos desde que existen datos.",paragraph,173,33,422,595
info_cubo_produccionCientifica_v13.md,"** Artículos **
Número de artículos publicados.",paragraph,47,10,597,644
info_cubo_produccionCientifica_v13.md,">Se recomienda incorporar a la consulta la dimensión 'AÑO' para que se muestren los datos por año. De lo
contrario se acumularán todos los artículos desde que existen datos.",paragraph,173,33,646,819
info_cubo_produccionCientifica_v13.md,"** Capítulos de libro **
Número de capítulos de libro publicados.",paragraph,65,14,821,886
info_cubo_produccionCientifica_v13.md,">Se recomienda incorporar a la consulta la dimensión 'AÑO' para que se muestren los datos por año. De lo
contrario se acumularán todos los capítulos de libro desde que existen datos.",paragraph,182,35,888,1070
info_cubo_produccionCientifica_v13.md,"** Libros **
Número de libros publicados.",paragraph,41,10,1072,1113
info_cubo_produccionCientifica_v13.md,">Se recomienda incorporar a la consulta la dimensión 'AÑO' para que se muestren los datos por año. De lo
contrario se acumularán todos los libros desde que existen datos.",paragraph,170,33,1115,1285
info_cubo_produccionCientifica_v13.md,"** Actividades en congresos **
Número de actividades realizadas en congresos.",paragraph,77,14,1287,1364
info_cubo_produccionCientifica_v13.md,">Se recomienda incorporar a la consulta la dimensión 'AÑO' para que se muestren los datos por año. De lo
contrario se acumularán todas las actividades en congresos desde que existen datos.",paragraph,188,35,1366,1554
info_cubo_produccionCientifica_v13.md,=== DIMENSIONES ===,paragraph,19,3,1556,1575
info_cubo_produccionCientifica_v13.md,## DIMENSION: Autor ##,paragraph,22,7,1577,1599
info_cubo_produccionCientifica_v13.md,"Atributos:
• Centro:
Permite clasificar los datos en función del centro al que pertenecen los autores.",paragraph,102,19,1601,1703
info_cubo_produccionCientifica_v13.md,"• Departamento:
Permite clasificar los datos en función del departamento al que están adscritos los autores.",paragraph,108,18,1705,1813
info_cubo_produccionCientifica_v13.md,"• Edad:
Permite agrupar los rangos de edad de los autores en función de su fecha de nacimiento.",paragraph,95,20,1815,1910
info_cubo_produccionCientifica_v13.md,">Valores posibles: 20 años o menos, 21 a 30, 31 a 40, 41 a 50, 51 a 60, 60 años o más.",paragraph,86,30,1912,1998
info_cubo_produccionCientifica_v13.md,"• Grupo de investigación:
Permite clasificar los datos en función del grupo de investigación al que pertenecen los autores.",paragraph,123,21,2000,2123
info_cubo_produccionCientifica_v13.md,"• Instituto de investigación:
Permite clasificar los datos en función del instituto universitario de investigación al que pertenecen los autor",paragraph,142,21,2125,2267
info_cubo_produccionCientifica_v13.md,"• Macroárea:
Permite clasificar los datos en función de la macroárea a la que pertenecen los autores.",paragraph,101,19,2269,2370
info_cubo_produccionCientifica_v13.md,">Valores posibles: Artes y Humanidades, Ciencias, Ciencias Sociales y Jurídicas, Ciencias de la Salud, Ingenierí
Arquitectura.",paragraph,126,23,2372,2498
info_cubo_produccionCientifica_v13.md,"• Nacionalidad:
Permite clasificar los datos en función de la nacionalidad legal de los autores.",paragraph,96,17,2500,2596
info_cubo_produccionCientifica_v13.md,"• Otros Centros de Investigación:
Permite clasificar los datos en función de si el autor pertenece a otros centros de investigación distintos de lo institutos universitarios de investigación. Ejemplo: INSTITUTO INVESTIGACIÓN SANITARIA DE ARAGÓN (IIS).",paragraph,251,41,2598,2849
info_cubo_produccionCientifica_v13.md,"• Sexo:
Permite agrupar a los autores en función de su sexo.",paragraph,60,14,2851,2911
info_cubo_produccionCientifica_v13.md,"• Área de conocimiento del autor:
Permite clasificar los datos en función del área de conocimiento a la que están adscritos los autores.",paragraph,136,25,2913,3049
info_cubo_produccionCientifica_v13.md,## DIMENSION: AÑO ##,paragraph,20,7,3051,3071
info_cubo_produccionCientifica_v13.md,"Notas generales:
- Permite clasificar la producción científica en función del año de su publicación o celebración).",paragraph,115,20,3073,3188
info_cubo_produccionCientifica_v13.md,## DIMENSION: Congreso ##,paragraph,25,7,3190,3215
info_cubo_produccionCientifica_v13.md,"Atributos:
• Categoría:
Permite clasificar las actividades en congresos en función de su categoría. Observaciones:",paragraph,114,19,3217,3331
info_cubo_produccionCientifica_v13.md,">Se recomienda cruzar esta variable sólo con la medida ""actividades en congresos"".
>Valores posibles: A+, A, B, C, no clasificado.",paragraph,130,31,3333,3463
info_cubo_produccionCientifica_v13.md,"• País:
Permite clasificar las actividades en congresos en función del país en que tienen lugar.",paragraph,96,18,3465,3561
info_cubo_produccionCientifica_v13.md,">Nota: sólo tiene sentido cruzar esta variable con la medida ""actividades en congresos"".",paragraph,88,18,3563,3651
info_cubo_produccionCientifica_v13.md,"• Tipo de actividad:
Permite clasificar las actividades en congresos en función del tipo de participación. Observaciones:",paragraph,121,20,3653,3774
info_cubo_produccionCientifica_v13.md,">Sólo tiene sentido cruzar esta variable con la medida ""actividades en congresos"".
>Valores posibles: ponencia invitada, ponencia, póster, comité organizador, comité científico, otros.",paragraph,184,35,3776,3960
info_cubo_produccionCientifica_v13.md,"• Ámbito geográfico:
Permite clasificar las actividades en congresos en función de su ámbito. Observaciones:",paragraph,108,18,3962,4070
info_cubo_produccionCientifica_v13.md,">Sólo tiene sentido cruzar esta variable con la medida ""actividades en congresos"".
>Valores posibles: autonómica, nacional, Unión Europea, internacional no UE, otros.",paragraph,166,33,4072,4238
info_cubo_produccionCientifica_v13.md,## DIMENSION: Fecha de actualización ##,paragraph,39,9,4240,4279
info_cubo_produccionCientifica_v13.md,"Notas generales:
- Indica la fecha de la última recarga de datos. Habitualmente es el domingo anterior a la consulta de datos.",paragraph,126,25,4281,4407
info_cubo_produccionCientifica_v13.md,## DIMENSION: Publicación ##,paragraph,28,7,4409,4437
info_cubo_produccionCientifica_v13.md,"Atributos:
• Artículo en Abierto (S/N):
Permite diferenciar los artículos que están publicados en abierto (S) de los que no lo están (N).",paragraph,137,32,4439,4576
info_cubo_produccionCientifica_v13.md,"> Sólo tiene sentido cruzar esta variable con la medida ""artículos"".",paragraph,68,14,4578,4646
info_cubo_produccionCientifica_v13.md,"• Idioma:
Permite clasificar los artículos, revistas editadas, capítulos de libros y libros en función del idioma en que está publicados.",paragraph,137,25,4648,4785
info_cubo_produccionCientifica_v13.md,">Nota: esta dimensión no está informada en la medida ""actividades en congresos"".",paragraph,80,17,4787,4867
info_cubo_produccionCientifica_v13.md,"• Tipo de artículo:
Permite clasificar los artículos en función de su tipología. Observaciones:",paragraph,95,17,4869,4964
info_cubo_produccionCientifica_v13.md,">Se recomienda cruzar esta variable sólo con la medida ""artículos"".
>Valores posibles: artículo científico, revisión, editorial, carta, texto académico, comunicación, ensayo clínico
corrección, reseña.",paragraph,201,38,4966,5167
info_cubo_produccionCientifica_v13.md,"=== MEDIDAS ===

** Número de autores **
Número de investigadores que cumplen en el periodo seleccionado alguna de las siguientes condiciones: • Son autores de al menos un artículo publicado.",sentence,191,35,0,191
info_cubo_produccionCientifica_v13.md,• Son autores de al menos un libro o capítulo de libro publicado.,sentence,65,14,191,256
info_cubo_produccionCientifica_v13.md,"• Tienen presencia en al menos un congreso celebrado, ya sea a nivel organizativo (en el comité científ y organizador) o participativo (ponencia, póster u otros).",sentence,162,33,257,419
info_cubo_produccionCientifica_v13.md,>Se recomienda incorporar a la consulta la dimensión 'AÑO' para que se muestren los datos por año.,sentence,98,20,420,518
info_cubo_produccionCientifica_v13.md,"De lo
contrario se acumularán todos los artículos desde que existen datos.",sentence,74,13,520,594
info_cubo_produccionCientifica_v13.md,"** Artículos **
Número de artículos publicados.",sentence,47,10,595,642
info_cubo_produccionCientifica_v13.md,>Se recomienda incorporar a la consulta la dimensión 'AÑO' para que se muestren los datos por año.,sentence,98,20,644,742
info_cubo_produccionCientifica_v13.md,"De lo
contrario se acumularán todos los artículos desde que existen datos.",sentence,74,13,744,818
info_cubo_produccionCientifica_v13.md,"** Capítulos de libro **
Número de capítulos de libro publicados.",sentence,65,14,819,884
info_cubo_produccionCientifica_v13.md,>Se recomienda incorporar a la consulta la dimensión 'AÑO' para que se muestren los datos por año.,sentence,98,20,886,984
info_cubo_produccionCientifica_v13.md,"De lo
contrario se acumularán todos los capítulos de libro desde que existen datos.",sentence,83,15,986,1069
info_cubo_produccionCientifica_v13.md,"** Libros **
Número de libros publicados.",sentence,41,10,1070,1111
info_cubo_produccionCientifica_v13.md,>Se recomienda incorporar a la consulta la dimensión 'AÑO' para que se muestren los datos por año.,sentence,98,20,1113,1211
info_cubo_produccionCientifica_v13.md,"De lo
contrario se acumularán todos los libros desde que existen datos.",sentence,71,13,1213,1284
info_cubo_produccionCientifica_v13.md,"** Actividades en congresos **
Número de actividades realizadas en congresos.",sentence,77,14,1285,1362
info_cubo_produccionCientifica_v13.md,>Se recomienda incorporar a la consulta la dimensión 'AÑO' para que se muestren los datos por año.,sentence,98,20,1364,1462
info_cubo_produccionCientifica_v13.md,"De lo
contrario se acumularán todas las actividades en congresos desde que existen datos.",sentence,89,15,1464,1553
info_cubo_produccionCientifica_v13.md,"=== DIMENSIONES ===

## DIMENSION: Autor ##

Atributos:
• Centro:
Permite clasificar los datos en función del centro al que pertenecen los autores.",sentence,147,29,1554,1701
info_cubo_produccionCientifica_v13.md,"• Departamento:
Permite clasificar los datos en función del departamento al que están adscritos los autores.",sentence,108,18,1703,1811
info_cubo_produccionCientifica_v13.md,"• Edad:
Permite agrupar los rangos de edad de los autores en función de su fecha de nacimiento.",sentence,95,20,1813,1908
info_cubo_produccionCientifica_v13.md,">Valores posibles: 20 años o menos, 21 a 30, 31 a 40, 41 a 50, 51 a 60, 60 años o más.",sentence,86,30,1910,1996
info_cubo_produccionCientifica_v13.md,"• Grupo de investigación:
Permite clasificar los datos en función del grupo de investigación al que pertenecen los autores.",sentence,123,21,1998,2121
info_cubo_produccionCientifica_v13.md,"• Instituto de investigación:
Permite clasificar los datos en función del instituto universitario de investigación al que pertenecen los autor

• Macroárea:
Permite clasificar los datos en función de la macroárea a la que pertenecen los autores.",sentence,245,40,2123,2368
info_cubo_produccionCientifica_v13.md,">Valores posibles: Artes y Humanidades, Ciencias, Ciencias Sociales y Jurídicas, Ciencias de la Salud, Ingenierí
Arquitectura.",sentence,126,23,2370,2496
info_cubo_produccionCientifica_v13.md,"• Nacionalidad:
Permite clasificar los datos en función de la nacionalidad legal de los autores.",sentence,96,17,2498,2594
info_cubo_produccionCientifica_v13.md,"• Otros Centros de Investigación:
Permite clasificar los datos en función de si el autor pertenece a otros centros de investigación distintos de lo institutos universitarios de investigación.",sentence,191,30,2596,2787
info_cubo_produccionCientifica_v13.md,Ejemplo: INSTITUTO INVESTIGACIÓN SANITARIA DE ARAGÓN (IIS).,sentence,59,11,2789,2848
info_cubo_produccionCientifica_v13.md,"• Sexo:
Permite agrupar a los autores en función de su sexo.",sentence,60,14,2849,2909
info_cubo_produccionCientifica_v13.md,"• Área de conocimiento del autor:
Permite clasificar los datos en función del área de conocimiento a la que están adscritos los autores.",sentence,136,25,2911,3047
info_cubo_produccionCientifica_v13.md,"## DIMENSION: AÑO ##

Notas generales:
- Permite clasificar la producción científica en función del año de su publicación o celebración).",sentence,137,27,3049,3186
info_cubo_produccionCientifica_v13.md,"## DIMENSION: Congreso ##

Atributos:
• Categoría:
Permite clasificar las actividades en congresos en función de su categoría.",sentence,126,24,3188,3314
info_cubo_produccionCientifica_v13.md,"Observaciones:

>Se recomienda cruzar esta variable sólo con la medida ""actividades en congresos"".",sentence,98,18,3316,3414
info_cubo_produccionCientifica_v13.md,">Valores posibles: A+, A, B, C, no clasificado.",sentence,47,15,3415,3462
info_cubo_produccionCientifica_v13.md,"• País:
Permite clasificar las actividades en congresos en función del país en que tienen lugar.",sentence,96,18,3463,3559
info_cubo_produccionCientifica_v13.md,">Nota: sólo tiene sentido cruzar esta variable con la medida ""actividades en congresos"".",sentence,88,18,3561,3649
info_cubo_produccionCientifica_v13.md,"• Tipo de actividad:
Permite clasificar las actividades en congresos en función del tipo de participación.",sentence,106,18,3651,3757
info_cubo_produccionCientifica_v13.md,"Observaciones:

>Sólo tiene sentido cruzar esta variable con la medida ""actividades en congresos"".",sentence,98,18,3759,3857
info_cubo_produccionCientifica_v13.md,">Valores posibles: ponencia invitada, ponencia, póster, comité organizador, comité científico, otros.",sentence,101,19,3858,3959
info_cubo_produccionCientifica_v13.md,"• Ámbito geográfico:
Permite clasificar las actividades en congresos en función de su ámbito.",sentence,93,16,3960,4053
info_cubo_produccionCientifica_v13.md,"Observaciones:

>Sólo tiene sentido cruzar esta variable con la medida ""actividades en congresos"".",sentence,98,18,4055,4153
info_cubo_produccionCientifica_v13.md,">Valores posibles: autonómica, nacional, Unión Europea, internacional no UE, otros.",sentence,83,17,4154,4237
info_cubo_produccionCientifica_v13.md,"## DIMENSION: Fecha de actualización ##

Notas generales:
- Indica la fecha de la última recarga de datos.",sentence,106,23,4238,4344
info_cubo_produccionCientifica_v13.md,Habitualmente es el domingo anterior a la consulta de datos.,sentence,60,11,4346,4406
info_cubo_produccionCientifica_v13.md,"## DIMENSION: Publicación ##

Atributos:
• Artículo en Abierto (S/N):
Permite diferenciar los artículos que están publicados en abierto (S) de los que no lo están (N).",sentence,167,39,4407,4574
info_cubo_produccionCientifica_v13.md,"> Sólo tiene sentido cruzar esta variable con la medida ""artículos"".",sentence,68,14,4576,4644
info_cubo_produccionCientifica_v13.md,"• Idioma:
Permite clasificar los artículos, revistas editadas, capítulos de libros y libros en función del idioma en que está publicados.",sentence,137,25,4646,4783
info_cubo_produccionCientifica_v13.md,">Nota: esta dimensión no está informada en la medida ""actividades en congresos"".",sentence,80,17,4785,4865
info_cubo_produccionCientifica_v13.md,"• Tipo de artículo:
Permite clasificar los artículos en función de su tipología.",sentence,80,15,4867,4947
info_cubo_produccionCientifica_v13.md,"Observaciones:

>Se recomienda cruzar esta variable sólo con la medida ""artículos"".",sentence,83,16,4949,5032
info_cubo_produccionCientifica_v13.md,">Valores posibles: artículo científico, revisión, editorial, carta, texto académico, comunicación, ensayo clínico
corrección, reseña.",sentence,133,24,5033,5166
info_cubo_proyectos_v11.md,"=== MEDIDAS ===

** Nº proyectos vigentes **
Número de proyectos de I+D+i activos en un año determinado (con algún movimiento contable en el año solicitado).

** Nº proyectos nuevos **
Número de proyectos nuevos de I+D+i en un año determinado.

** Importe concedido **
Es el importe que consta en la concesión del proyecto/contrato, siempre relacionado con la dimensión Año.

** Ingresos Totales **
Corresponde a los ingresos en proyectos/contratos, realizados en un ejercicio contable.

** Ingresos IVA **
Ingresos por IVA en un ejercicio contable.

** Ingresos Overhead **
Ingresos por costes indirectos en un ejercicio contable.

** Ingresos Proyecto **
Ingresos netos que se contabilizan en los proyectos/contratos.

** Costes totales del gasto **
Gastos externos y transferencias internas cargados en proyectos/contratos correspondientes a un ejercicio contable. La cifra total incluye el importe base de las facturas y el IVA.

** Costes de IVA **
Gastos de IVA en proyectos/contratos correspondientes a un ejercicio contable.

** Costes al proyecto **
Importe de los gastos totales que se imputa a los proyectos/contratos.",section,1130,209,0,1130
info_cubo_proyectos_v11.md,=== DIMENSIONES ===,section,20,3,1131,1151
info_cubo_proyectos_v11.md,"## DIMENSION: AÑO ##

Notas generales:
- Permite clasificar los proyectos/contratos en función del año natural.",section,112,21,1152,1264
info_cubo_proyectos_v11.md,"## DIMENSION: Costes ##

Atributos:
• Concepto:
Permite identificar el concepto contable de los gastos realizados en un proyecto de I+D+i.

>Ejemplos de valores posibles: Bienes y servicios, Gastos generales, Gastos de funcionamiento, Dietas y viajes,
Material Bibliográfico, Fungible, Inventariable, Equipo de Laboratorio, Estancias.",section,335,61,1265,1600
info_cubo_proyectos_v11.md,"## DIMENSION: Fecha de actualización ##

Notas generales:
- Fecha de la última recarga de datos.",section,97,21,1601,1698
info_cubo_proyectos_v11.md,"## DIMENSION: Investigador ##

Atributos:
• Centro:
Permite clasificar los datos en función del centro al que pertenece el investigador principal de cada proyecto. Esta dimensión se desagrega en dos atributos: Localidad Centro y Centro.

• Departamento:
Permite clasificar los datos en función del departamento al que está adscrito el investigador principal de cada proyecto.

• Grupo de Investigación:
Permite clasificar los datos en función del grupo de investigación al que pertenece el investigador principal de cada proyecto.

• Instituto de Investigación:
Permite clasificar los datos en función del instituto universitario de investigación al que pertenece el investigador principal de cada proyecto.

• Macroárea:
Permite clasificar los datos en función de la macroárea a la que pertenece el investigador principal de cada proyecto.

>Valores posibles: Artes y Humanidades, Ciencias, Ciencias Sociales y Jurídicas, Ciencias de la Salud, Ingeniería y
Arquitectura.

• Otros centros de investigación:
Permite clasificar los datos en función de si investigadores pertenecen o no a estructuras de investigación distintas de los institutos universitarios de investigación.

>Ejemplo: IIS ‐ Instituto de Investigación Sanitaria de Aragón.

• Área:
Permite clasificar los datos en función del área de conocimiento a la que está adscrito el investigador principal de cada proyecto.",section,1382,230,1699,3081
info_cubo_proyectos_v11.md,"## DIMENSION: Proyecto ##

Atributos:
• Agrupación:
Clasifica los proyectos/contratos según los valores siguientes:

>Valores posibles: Proy. de Investigación Básica (no Europeos), Proy. de Investigación Básica Europeos, Proy.
colaborativos con Empresa, Contratos y Convenios.

• Categoría baremo:
Clasifica los proyectos/contratos según los valores: Proyectos I+D en convocatorias no competitivas, Asesorías I+D en convocatorias no competitivas, Servicios en convocatorias no competitivas, Proyectos no baremables, Proyectos en convocatorias competitivas.

• Oficina gestora:
Permite obtener los datos clasificados por las oficinas gestoras. Esta dimensión se desagrega en dos atributos: Oficina Gestora (Siglas)

>Valores posibles: OPE, OTRI; SGI,EXT,TODAS
Oficina Gestora

>Valores posibles: Oficina de Proyectos Europeos, Oficina de Transferencia de Resultados de Investigación,
Servicio de Gestión de la Investigación, Proyectos externos.

• Sector industrial:
Pendiente añadir listado de valores

• Tipo de oportunidad:
Clasificación de los proyectos/contratos según los siguientes valores:

>Valores posibles: Contrato, Convenio, Convocatoria, Subcontratación convocatoria.

• Tipo de proyecto:
Clasifica los proyectos/contratos según los siguientes valores: Grupos, Proyectos I+D+I, Proyectos colaborativos, Movilidades, Asesorías, Cursos y seminarios, Servicios técnicos, Recursos Humanos, Infraestructuras, Royalties/Licencias, Mecenazgo/Donaciones, CIT, Proyectos Colaborativos, Otros.

• Ámbito territorial:
Permite identificar el ámbito de un proyecto.",section,1567,256,3082,4649
info_cubo_proyectos_v11.md,=== MEDIDAS ===,paragraph,15,3,0,15
info_cubo_proyectos_v11.md,"** Nº proyectos vigentes **
Número de proyectos de I+D+i activos en un año determinado (con algún movimiento contable en el año solicitado).",paragraph,140,28,17,157
info_cubo_proyectos_v11.md,"** Nº proyectos nuevos **
Número de proyectos nuevos de I+D+i en un año determinado.",paragraph,84,18,159,243
info_cubo_proyectos_v11.md,"** Importe concedido **
Es el importe que consta en la concesión del proyecto/contrato, siempre relacionado con la dimensión Año.",paragraph,129,24,245,374
info_cubo_proyectos_v11.md,"** Ingresos Totales **
Corresponde a los ingresos en proyectos/contratos, realizados en un ejercicio contable.",paragraph,110,19,376,486
info_cubo_proyectos_v11.md,"** Ingresos IVA **
Ingresos por IVA en un ejercicio contable.",paragraph,61,14,488,549
info_cubo_proyectos_v11.md,"** Ingresos Overhead **
Ingresos por costes indirectos en un ejercicio contable.",paragraph,80,15,551,631
info_cubo_proyectos_v11.md,"** Ingresos Proyecto **
Ingresos netos que se contabilizan en los proyectos/contratos.",paragraph,86,15,633,719
info_cubo_proyectos_v11.md,"** Costes totales del gasto **
Gastos externos y transferencias internas cargados en proyectos/contratos correspondientes a un ejercicio contable. La cifra total incluye el importe base de las facturas y el IVA.",paragraph,211,36,721,932
info_cubo_proyectos_v11.md,"** Costes de IVA **
Gastos de IVA en proyectos/contratos correspondientes a un ejercicio contable.",paragraph,98,18,934,1032
info_cubo_proyectos_v11.md,"** Costes al proyecto **
Importe de los gastos totales que se imputa a los proyectos/contratos.",paragraph,95,19,1034,1129
info_cubo_proyectos_v11.md,=== DIMENSIONES ===,paragraph,19,3,1131,1150
info_cubo_proyectos_v11.md,## DIMENSION: AÑO ##,paragraph,20,7,1152,1172
info_cubo_proyectos_v11.md,"Notas generales:
- Permite clasificar los proyectos/contratos en función del año natural.",paragraph,89,14,1174,1263
info_cubo_proyectos_v11.md,## DIMENSION: Costes ##,paragraph,23,7,1265,1288
info_cubo_proyectos_v11.md,"Atributos:
• Concepto:
Permite identificar el concepto contable de los gastos realizados en un proyecto de I+D+i.",paragraph,113,20,1290,1403
info_cubo_proyectos_v11.md,">Ejemplos de valores posibles: Bienes y servicios, Gastos generales, Gastos de funcionamiento, Dietas y viajes,
Material Bibliográfico, Fungible, Inventariable, Equipo de Laboratorio, Estancias.",paragraph,194,34,1405,1599
info_cubo_proyectos_v11.md,## DIMENSION: Fecha de actualización ##,paragraph,39,9,1601,1640
info_cubo_proyectos_v11.md,"Notas generales:
- Fecha de la última recarga de datos.",paragraph,55,12,1642,1697
info_cubo_proyectos_v11.md,## DIMENSION: Investigador ##,paragraph,29,7,1699,1728
info_cubo_proyectos_v11.md,"Atributos:
• Centro:
Permite clasificar los datos en función del centro al que pertenece el investigador principal de cada proyecto. Esta dimensión se desagrega en dos atributos: Localidad Centro y Centro.",paragraph,205,36,1730,1935
info_cubo_proyectos_v11.md,"• Departamento:
Permite clasificar los datos en función del departamento al que está adscrito el investigador principal de cada proyecto.",paragraph,137,22,1937,2074
info_cubo_proyectos_v11.md,"• Grupo de Investigación:
Permite clasificar los datos en función del grupo de investigación al que pertenece el investigador principal de cada proyecto.",paragraph,153,25,2076,2229
info_cubo_proyectos_v11.md,"• Instituto de Investigación:
Permite clasificar los datos en función del instituto universitario de investigación al que pertenece el investigador principal de cada proyecto.",paragraph,175,26,2231,2406
info_cubo_proyectos_v11.md,"• Macroárea:
Permite clasificar los datos en función de la macroárea a la que pertenece el investigador principal de cada proyecto.",paragraph,131,23,2408,2539
info_cubo_proyectos_v11.md,">Valores posibles: Artes y Humanidades, Ciencias, Ciencias Sociales y Jurídicas, Ciencias de la Salud, Ingeniería y
Arquitectura.",paragraph,129,24,2541,2670
info_cubo_proyectos_v11.md,"• Otros centros de investigación:
Permite clasificar los datos en función de si investigadores pertenecen o no a estructuras de investigación distintas de los institutos universitarios de investigación.",paragraph,202,30,2672,2874
info_cubo_proyectos_v11.md,>Ejemplo: IIS ‐ Instituto de Investigación Sanitaria de Aragón.,paragraph,63,12,2876,2939
info_cubo_proyectos_v11.md,"• Área:
Permite clasificar los datos en función del área de conocimiento a la que está adscrito el investigador principal de cada proyecto.",paragraph,139,25,2941,3080
info_cubo_proyectos_v11.md,## DIMENSION: Proyecto ##,paragraph,25,7,3082,3107
info_cubo_proyectos_v11.md,"Atributos:
• Agrupación:
Clasifica los proyectos/contratos según los valores siguientes:",paragraph,88,13,3109,3197
info_cubo_proyectos_v11.md,">Valores posibles: Proy. de Investigación Básica (no Europeos), Proy. de Investigación Básica Europeos, Proy.
colaborativos con Empresa, Contratos y Convenios.",paragraph,159,31,3199,3358
info_cubo_proyectos_v11.md,"• Categoría baremo:
Clasifica los proyectos/contratos según los valores: Proyectos I+D en convocatorias no competitivas, Asesorías I+D en convocatorias no competitivas, Servicios en convocatorias no competitivas, Proyectos no baremables, Proyectos en convocatorias competitivas.",paragraph,278,40,3360,3638
info_cubo_proyectos_v11.md,"• Oficina gestora:
Permite obtener los datos clasificados por las oficinas gestoras. Esta dimensión se desagrega en dos atributos: Oficina Gestora (Siglas)",paragraph,155,27,3640,3795
info_cubo_proyectos_v11.md,">Valores posibles: OPE, OTRI; SGI,EXT,TODAS
Oficina Gestora",paragraph,59,15,3797,3856
info_cubo_proyectos_v11.md,">Valores posibles: Oficina de Proyectos Europeos, Oficina de Transferencia de Resultados de Investigación,
Servicio de Gestión de la Investigación, Proyectos externos.",paragraph,167,27,3858,4025
info_cubo_proyectos_v11.md,"• Sector industrial:
Pendiente añadir listado de valores",paragraph,56,9,4027,4083
info_cubo_proyectos_v11.md,"• Tipo de oportunidad:
Clasificación de los proyectos/contratos según los siguientes valores:",paragraph,93,14,4085,4178
info_cubo_proyectos_v11.md,">Valores posibles: Contrato, Convenio, Convocatoria, Subcontratación convocatoria.",paragraph,82,13,4180,4262
info_cubo_proyectos_v11.md,"• Tipo de proyecto:
Clasifica los proyectos/contratos según los siguientes valores: Grupos, Proyectos I+D+I, Proyectos colaborativos, Movilidades, Asesorías, Cursos y seminarios, Servicios técnicos, Recursos Humanos, Infraestructuras, Royalties/Licencias, Mecenazgo/Donaciones, CIT, Proyectos Colaborativos, Otros.",paragraph,314,48,4264,4578
info_cubo_proyectos_v11.md,"• Ámbito territorial:
Permite identificar el ámbito de un proyecto.",paragraph,67,12,4580,4647
info_cubo_proyectos_v11.md,"=== MEDIDAS ===

** Nº proyectos vigentes **
Número de proyectos de I+D+i activos en un año determinado (con algún movimiento contable en el año solicitado).",sentence,157,31,0,157
info_cubo_proyectos_v11.md,"** Nº proyectos nuevos **
Número de proyectos nuevos de I+D+i en un año determinado.",sentence,84,18,157,241
info_cubo_proyectos_v11.md,"** Importe concedido **
Es el importe que consta en la concesión del proyecto/contrato, siempre relacionado con la dimensión Año.",sentence,129,24,243,372
info_cubo_proyectos_v11.md,"** Ingresos Totales **
Corresponde a los ingresos en proyectos/contratos, realizados en un ejercicio contable.",sentence,110,19,374,484
info_cubo_proyectos_v11.md,"** Ingresos IVA **
Ingresos por IVA en un ejercicio contable.",sentence,61,14,486,547
info_cubo_proyectos_v11.md,"** Ingresos Overhead **
Ingresos por costes indirectos en un ejercicio contable.",sentence,80,15,549,629
info_cubo_proyectos_v11.md,"** Ingresos Proyecto **
Ingresos netos que se contabilizan en los proyectos/contratos.",sentence,86,15,631,717
info_cubo_proyectos_v11.md,"** Costes totales del gasto **
Gastos externos y transferencias internas cargados en proyectos/contratos correspondientes a un ejercicio contable.",sentence,146,22,719,865
info_cubo_proyectos_v11.md,La cifra total incluye el importe base de las facturas y el IVA.,sentence,64,14,867,931
info_cubo_proyectos_v11.md,"** Costes de IVA **
Gastos de IVA en proyectos/contratos correspondientes a un ejercicio contable.",sentence,98,18,932,1030
info_cubo_proyectos_v11.md,"** Costes al proyecto **
Importe de los gastos totales que se imputa a los proyectos/contratos.",sentence,95,19,1032,1127
info_cubo_proyectos_v11.md,"=== DIMENSIONES ===

## DIMENSION: AÑO ##

Notas generales:
- Permite clasificar los proyectos/contratos en función del año natural.",sentence,132,24,1129,1261
info_cubo_proyectos_v11.md,"## DIMENSION: Costes ##

Atributos:
• Concepto:
Permite identificar el concepto contable de los gastos realizados en un proyecto de I+D+i.",sentence,138,27,1263,1401
info_cubo_proyectos_v11.md,">Ejemplos de valores posibles: Bienes y servicios, Gastos generales, Gastos de funcionamiento, Dietas y viajes,
Material Bibliográfico, Fungible, Inventariable, Equipo de Laboratorio, Estancias.",sentence,194,34,1403,1597
info_cubo_proyectos_v11.md,"## DIMENSION: Fecha de actualización ##

Notas generales:
- Fecha de la última recarga de datos.",sentence,96,21,1599,1695
info_cubo_proyectos_v11.md,"## DIMENSION: Investigador ##

Atributos:
• Centro:
Permite clasificar los datos en función del centro al que pertenece el investigador principal de cada proyecto.",sentence,163,30,1697,1860
info_cubo_proyectos_v11.md,Esta dimensión se desagrega en dos atributos: Localidad Centro y Centro.,sentence,72,13,1862,1934
info_cubo_proyectos_v11.md,"• Departamento:
Permite clasificar los datos en función del departamento al que está adscrito el investigador principal de cada proyecto.",sentence,137,22,1935,2072
info_cubo_proyectos_v11.md,"• Grupo de Investigación:
Permite clasificar los datos en función del grupo de investigación al que pertenece el investigador principal de cada proyecto.",sentence,153,25,2074,2227
info_cubo_proyectos_v11.md,"• Instituto de Investigación:
Permite clasificar los datos en función del instituto universitario de investigación al que pertenece el investigador principal de cada proyecto.",sentence,175,26,2229,2404
info_cubo_proyectos_v11.md,"• Macroárea:
Permite clasificar los datos en función de la macroárea a la que pertenece el investigador principal de cada proyecto.",sentence,131,23,2406,2537
info_cubo_proyectos_v11.md,">Valores posibles: Artes y Humanidades, Ciencias, Ciencias Sociales y Jurídicas, Ciencias de la Salud, Ingeniería y
Arquitectura.",sentence,129,24,2539,2668
info_cubo_proyectos_v11.md,"• Otros centros de investigación:
Permite clasificar los datos en función de si investigadores pertenecen o no a estructuras de investigación distintas de los institutos universitarios de investigación.",sentence,202,30,2670,2872
info_cubo_proyectos_v11.md,>Ejemplo: IIS ‐ Instituto de Investigación Sanitaria de Aragón.,sentence,63,12,2874,2937
info_cubo_proyectos_v11.md,"• Área:
Permite clasificar los datos en función del área de conocimiento a la que está adscrito el investigador principal de cada proyecto.",sentence,139,25,2939,3078
info_cubo_proyectos_v11.md,"## DIMENSION: Proyecto ##

Atributos:
• Agrupación:
Clasifica los proyectos/contratos según los valores siguientes:

>Valores posibles: Proy.",sentence,141,26,3080,3221
info_cubo_proyectos_v11.md,"de Investigación Básica (no Europeos), Proy.",sentence,44,10,3223,3267
info_cubo_proyectos_v11.md,"de Investigación Básica Europeos, Proy.",sentence,39,7,3268,3307
info_cubo_proyectos_v11.md,"colaborativos con Empresa, Contratos y Convenios.",sentence,49,8,3308,3357
info_cubo_proyectos_v11.md,"• Categoría baremo:
Clasifica los proyectos/contratos según los valores: Proyectos I+D en convocatorias no competitivas, Asesorías I+D en convocatorias no competitivas, Servicios en convocatorias no competitivas, Proyectos no baremables, Proyectos en convocatorias competitivas.",sentence,278,40,3358,3636
info_cubo_proyectos_v11.md,"• Oficina gestora:
Permite obtener los datos clasificados por las oficinas gestoras.",sentence,84,14,3638,3722
info_cubo_proyectos_v11.md,"Esta dimensión se desagrega en dos atributos: Oficina Gestora (Siglas)

>Valores posibles: OPE, OTRI; SGI,EXT,TODAS
Oficina Gestora

>Valores posibles: Oficina de Proyectos Europeos, Oficina de Transferencia de Resultados de Investigación,
Servicio de Gestión de la Investigación, Proyectos externos.",sentence,300,55,3724,4024
info_cubo_proyectos_v11.md,"• Sector industrial:
Pendiente añadir listado de valores

• Tipo de oportunidad:
Clasificación de los proyectos/contratos según los siguientes valores:

>Valores posibles: Contrato, Convenio, Convocatoria, Subcontratación convocatoria.",sentence,235,36,4025,4260
info_cubo_proyectos_v11.md,"• Tipo de proyecto:
Clasifica los proyectos/contratos según los siguientes valores: Grupos, Proyectos I+D+I, Proyectos colaborativos, Movilidades, Asesorías, Cursos y seminarios, Servicios técnicos, Recursos Humanos, Infraestructuras, Royalties/Licencias, Mecenazgo/Donaciones, CIT, Proyectos Colaborativos, Otros.",sentence,314,48,4262,4576
info_cubo_proyectos_v11.md,"• Ámbito territorial:
Permite identificar el ámbito de un proyecto.",sentence,67,12,4578,4645
info_cubo_PTGAS_v21.md,"=== MEDIDAS ===

** Número de PTGAS **
Número de efectivos de Personal Técnico, de Gestión, de Administración y Servicios (PTGAS) que constan en bases de datos de personal con contrato activo a la fecha de consulta. Observaciones:

>IMPORTANTE: se debe utilizar la dimensión TIEMPO (año o mes) para filtrar el número de efectivos en un
periodo o fecha concreta. Se incluye la totalidad de efectivos, estén ocupando o no su puesto.",section,431,87,0,431
info_cubo_PTGAS_v21.md,=== DIMENSIONES ===,section,20,3,432,452
info_cubo_PTGAS_v21.md,"## DIMENSION: Compatibilidad ##

Atributos:
• Concedida (S/N):
Permite clasificar los datos en función de si los empleados tienen concedida (S) o no (N), por esta institución, compatibilidad con otras actividades públicas o privadas.",section,234,48,453,687
info_cubo_PTGAS_v21.md,"## DIMENSION: Contrato ##

Atributos:
• Categoría Cuerpo Escala:
Permite clasificar los datos en función de la categoría/cuerpo/escala a la que pertenecen los empleados.

• Dedicación:
Identifica el tipo de dedicación que tienen los empleados.

>Valores posibles: tiempo completo, tiempo parcial.

• Grado complemento:
Permite agrupar los datos en función del grado de complemento personal consolidado por los empleados.

>Nota: en caso de que el empleado no haya consolidado grado de complemento se indica ""No informado"".

• Grupo:
Permite agrupar los datos en función del grupo de pertenencia laboral de los empleados.

>Valores posibles: A1, A2, C1, C2, LA, LB, LC, LD.

• Régimen Jurídico:
Permite agrupar a los empleados en función del régimen jurídico en el que se adscribe su nombramiento o contrato.

>Valores posibles: funcionario, laboral.

• Situación Administrativa:
Permite agrupar los empleados en función de la situación administrativa en la que se encuentren.

>Ejemplos: servicio activo, excedencia, suspensión de contrato, servicios especiales.

• Tipo personal:
Permite agrupar los empleados en función de la modalidad de régimen jurídico.

>Valores posibles: de carrera, interino, indefinido fijo, temporal, en prácticas.",section,1242,234,688,1930
info_cubo_PTGAS_v21.md,"## DIMENSION: Fecha de actualización ##

Notas generales:
- Indica la fecha de la última recarga de datos. Habitualmente es el domingo anterior a la consulta de datos.",section,168,34,1931,2099
info_cubo_PTGAS_v21.md,"## DIMENSION: Persona ##

Atributos:
• Edad:
Permite agrupar los empleados en función de su edad a fecha 31 de diciembre del año seleccionado.

>Valores posibles: 21-25, 26-30, 31-35, 36-40, 41-45, 46-50, 51-55, 56-60, 61-65,>65.

• Nivel Titulación:
Permite clasificar los datos en función del nivel de titulación de los empleados.

>Valores posibles: Doctor, Máster, Grado, Licenciados o equivalentes, Diplomados o equivalentes, Bachiller
Superior o equivalente, Bachiller elemental o equivalente, Enseñanza primaria o equivalente.

• País Nacionalidad:
Permite clasificar los datos en función del país de nacionalidad legal del personal.

• Residencia:
Identifica el país, la comunidad autónoma, la provincia o la población de residencia familiar informada por lo empleados.

• Sexo:
Permite clasificar los empleados en función de su sexo.",section,843,161,2100,2943
info_cubo_PTGAS_v21.md,"## DIMENSION: Puesto ##

Atributos:
• Categoría:
Permite clasificar los datos en función de la categoría del puesto que ocupan los empleados.

• Centro:
Permite clasificar los datos en función del centro al que están adscritos los empleados.

• Centro Localidad:
Permite clasificar los datos en función de la localidad donde se sitúa el centro al que están adscritos los empleados.

• Especialidad RPT:
Permite clasificar a los empleados en función de la especialidad a la que está asignado en la Relación de Puestos de Trabajo el puesto que ocupan.

>Valores posibles: Área de Administración y Servicios Generales, Área Técnica, de Mantenimiento y Oficios,
Apoyo a la Docencia e Investigación y Laboratorios, Fuera RPT.

• PTGAS de Investigación (S/N):
Permite distinguir si los efectivos de PTGAS se remuneran con cargo a proyectos de investigación (S) o no (N)

>Observación: se considerarán PTGAS de Investigación si ocupan puestos asignados a los programas 148I,
171I, 417-I, 423-I ó 425-I.

• Unidad:
Permite clasificar los datos en función de la unidad a la que están adscritos los empleados.",section,1100,209,2944,4044
info_cubo_PTGAS_v21.md,"## DIMENSION: Sindicato ##

Notas generales:
- Permite clasificar a los empleados en función de si tienen concedida o no algún tipo de reducción horaria par el desempeño de tareas sindicales.

>Nota: si los empleados tienen concedida reducción se detalla la denominación del sindicato y si no tienen
concedida reducción figura el valor “No Informado”.

Atributos:
• Reducción:
Identifica el porcentaje de reducción horaria o número de horas lectivas que se reducen por el desempeño d tareas sindicales, figuran con el valor “No informado”.

>Nota: si el empleado no tiene concedida reducción horaria, figura con el valor “Sin reducción”.",section,638,121,4045,4683
info_cubo_PTGAS_v21.md,"## DIMENSION: TIEMPO ##

Notas generales:
- Permite ubicar en el tiempo la relación del personal con la UZ. Se pueden desglosar los datos según el año o mes: • MES: se incluyen los efectivos existentes a fecha último día del mes seleccionado (si se trata de un m en curso, se incluyen los efectivos existentes a la fecha de la última carga). • AÑO: se acumulan los efectivos existentes a fecha último día de todos los meses del año seleccionad (si el año seleccionado es un año en curso, se acumulan los efectivos existentes a fecha último día de los meses anteriores y para el mes en curso los efectivos existentes a la fecha de la última carga).",section,648,135,4684,5332
info_cubo_PTGAS_v21.md,"## DIMENSION: Tramos ##

Atributos:
• Gestión Trienios:
Permite clasificar los datos en función del número de trienios o tramos de gestión que tienen reconocidos los empleados.

>Nota: contabiliza los trienios acumulados por el empleado en la fecha (año o mes) seleccionada en la
dimensión “tiempo”.",section,301,59,5333,5634
info_cubo_PTGAS_v21.md,=== MEDIDAS ===,paragraph,15,3,0,15
info_cubo_PTGAS_v21.md,"** Número de PTGAS **
Número de efectivos de Personal Técnico, de Gestión, de Administración y Servicios (PTGAS) que constan en bases de datos de personal con contrato activo a la fecha de consulta. Observaciones:",paragraph,213,43,17,230
info_cubo_PTGAS_v21.md,">IMPORTANTE: se debe utilizar la dimensión TIEMPO (año o mes) para filtrar el número de efectivos en un
periodo o fecha concreta. Se incluye la totalidad de efectivos, estén ocupando o no su puesto.",paragraph,198,41,232,430
info_cubo_PTGAS_v21.md,=== DIMENSIONES ===,paragraph,19,3,432,451
info_cubo_PTGAS_v21.md,## DIMENSION: Compatibilidad ##,paragraph,31,7,453,484
info_cubo_PTGAS_v21.md,"Atributos:
• Concedida (S/N):
Permite clasificar los datos en función de si los empleados tienen concedida (S) o no (N), por esta institución, compatibilidad con otras actividades públicas o privadas.",paragraph,200,41,486,686
info_cubo_PTGAS_v21.md,## DIMENSION: Contrato ##,paragraph,25,7,688,713
info_cubo_PTGAS_v21.md,"Atributos:
• Categoría Cuerpo Escala:
Permite clasificar los datos en función de la categoría/cuerpo/escala a la que pertenecen los empleados.",paragraph,142,23,715,857
info_cubo_PTGAS_v21.md,"• Dedicación:
Identifica el tipo de dedicación que tienen los empleados.",paragraph,72,13,859,931
info_cubo_PTGAS_v21.md,">Valores posibles: tiempo completo, tiempo parcial.",paragraph,51,10,933,984
info_cubo_PTGAS_v21.md,"• Grado complemento:
Permite agrupar los datos en función del grado de complemento personal consolidado por los empleados.",paragraph,122,20,986,1108
info_cubo_PTGAS_v21.md,">Nota: en caso de que el empleado no haya consolidado grado de complemento se indica ""No informado"".",paragraph,100,22,1110,1210
info_cubo_PTGAS_v21.md,"• Grupo:
Permite agrupar los datos en función del grupo de pertenencia laboral de los empleados.",paragraph,96,18,1212,1308
info_cubo_PTGAS_v21.md,">Valores posibles: A1, A2, C1, C2, LA, LB, LC, LD.",paragraph,50,20,1310,1360
info_cubo_PTGAS_v21.md,"• Régimen Jurídico:
Permite agrupar a los empleados en función del régimen jurídico en el que se adscribe su nombramiento o contrato.",paragraph,133,24,1362,1495
info_cubo_PTGAS_v21.md,">Valores posibles: funcionario, laboral.",paragraph,40,8,1497,1537
info_cubo_PTGAS_v21.md,"• Situación Administrativa:
Permite agrupar los empleados en función de la situación administrativa en la que se encuentren.",paragraph,124,20,1539,1663
info_cubo_PTGAS_v21.md,">Ejemplos: servicio activo, excedencia, suspensión de contrato, servicios especiales.",paragraph,85,15,1665,1750
info_cubo_PTGAS_v21.md,"• Tipo personal:
Permite agrupar los empleados en función de la modalidad de régimen jurídico.",paragraph,94,17,1752,1846
info_cubo_PTGAS_v21.md,">Valores posibles: de carrera, interino, indefinido fijo, temporal, en prácticas.",paragraph,81,17,1848,1929
info_cubo_PTGAS_v21.md,## DIMENSION: Fecha de actualización ##,paragraph,39,9,1931,1970
info_cubo_PTGAS_v21.md,"Notas generales:
- Indica la fecha de la última recarga de datos. Habitualmente es el domingo anterior a la consulta de datos.",paragraph,126,25,1972,2098
info_cubo_PTGAS_v21.md,## DIMENSION: Persona ##,paragraph,24,7,2100,2124
info_cubo_PTGAS_v21.md,"Atributos:
• Edad:
Permite agrupar los empleados en función de su edad a fecha 31 de diciembre del año seleccionado.",paragraph,116,23,2126,2242
info_cubo_PTGAS_v21.md,">Valores posibles: 21-25, 26-30, 31-35, 36-40, 41-45, 46-50, 51-55, 56-60, 61-65,>65.",paragraph,85,25,2244,2329
info_cubo_PTGAS_v21.md,"• Nivel Titulación:
Permite clasificar los datos en función del nivel de titulación de los empleados.",paragraph,101,18,2331,2432
info_cubo_PTGAS_v21.md,">Valores posibles: Doctor, Máster, Grado, Licenciados o equivalentes, Diplomados o equivalentes, Bachiller
Superior o equivalente, Bachiller elemental o equivalente, Enseñanza primaria o equivalente.",paragraph,199,33,2434,2633
info_cubo_PTGAS_v21.md,"• País Nacionalidad:
Permite clasificar los datos en función del país de nacionalidad legal del personal.",paragraph,105,18,2635,2740
info_cubo_PTGAS_v21.md,"• Residencia:
Identifica el país, la comunidad autónoma, la provincia o la población de residencia familiar informada por lo empleados.",paragraph,135,24,2742,2877
info_cubo_PTGAS_v21.md,"• Sexo:
Permite clasificar los empleados en función de su sexo.",paragraph,63,13,2879,2942
info_cubo_PTGAS_v21.md,## DIMENSION: Puesto ##,paragraph,23,7,2944,2967
info_cubo_PTGAS_v21.md,"Atributos:
• Categoría:
Permite clasificar los datos en función de la categoría del puesto que ocupan los empleados.",paragraph,116,21,2969,3085
info_cubo_PTGAS_v21.md,"• Centro:
Permite clasificar los datos en función del centro al que están adscritos los empleados.",paragraph,98,18,3087,3185
info_cubo_PTGAS_v21.md,"• Centro Localidad:
Permite clasificar los datos en función de la localidad donde se sitúa el centro al que están adscritos los empleados.",paragraph,138,25,3187,3325
info_cubo_PTGAS_v21.md,"• Especialidad RPT:
Permite clasificar a los empleados en función de la especialidad a la que está asignado en la Relación de Puestos de Trabajo el puesto que ocupan.",paragraph,166,31,3327,3493
info_cubo_PTGAS_v21.md,">Valores posibles: Área de Administración y Servicios Generales, Área Técnica, de Mantenimiento y Oficios,
Apoyo a la Docencia e Investigación y Laboratorios, Fuera RPT.",paragraph,169,31,3495,3664
info_cubo_PTGAS_v21.md,"• PTGAS de Investigación (S/N):
Permite distinguir si los efectivos de PTGAS se remuneran con cargo a proyectos de investigación (S) o no (N)",paragraph,141,31,3666,3807
info_cubo_PTGAS_v21.md,">Observación: se considerarán PTGAS de Investigación si ocupan puestos asignados a los programas 148I,
171I, 417-I, 423-I ó 425-I.",paragraph,130,25,3809,3939
info_cubo_PTGAS_v21.md,"• Unidad:
Permite clasificar los datos en función de la unidad a la que están adscritos los empleados.",paragraph,102,20,3941,4043
info_cubo_PTGAS_v21.md,## DIMENSION: Sindicato ##,paragraph,26,7,4045,4071
info_cubo_PTGAS_v21.md,"Notas generales:
- Permite clasificar a los empleados en función de si tienen concedida o no algún tipo de reducción horaria par el desempeño de tareas sindicales.",paragraph,163,29,4073,4236
info_cubo_PTGAS_v21.md,">Nota: si los empleados tienen concedida reducción se detalla la denominación del sindicato y si no tienen
concedida reducción figura el valor “No Informado”.",paragraph,158,29,4238,4396
info_cubo_PTGAS_v21.md,"Atributos:
• Reducción:
Identifica el porcentaje de reducción horaria o número de horas lectivas que se reducen por el desempeño d tareas sindicales, figuran con el valor “No informado”.",paragraph,186,35,4398,4584
info_cubo_PTGAS_v21.md,">Nota: si el empleado no tiene concedida reducción horaria, figura con el valor “Sin reducción”.",paragraph,96,21,4586,4682
info_cubo_PTGAS_v21.md,## DIMENSION: TIEMPO ##,paragraph,23,7,4684,4707
info_cubo_PTGAS_v21.md,"Notas generales:
- Permite ubicar en el tiempo la relación del personal con la UZ. Se pueden desglosar los datos según el año o mes: • MES: se incluyen los efectivos existentes a fecha último día del mes seleccionado (si se trata de un m en curso, se incluyen los efectivos existentes a la fecha de la última carga). • AÑO: se acumulan los efectivos existentes a fecha último día de todos los meses del año seleccionad (si el año seleccionado es un año en curso, se acumulan los efectivos existentes a fecha último día de los meses anteriores y para el mes en curso los efectivos existentes a la fecha de la última carga).",paragraph,622,128,4709,5331
info_cubo_PTGAS_v21.md,## DIMENSION: Tramos ##,paragraph,23,7,5333,5356
info_cubo_PTGAS_v21.md,"Atributos:
• Gestión Trienios:
Permite clasificar los datos en función del número de trienios o tramos de gestión que tienen reconocidos los empleados.",paragraph,151,26,5358,5509
info_cubo_PTGAS_v21.md,">Nota: contabiliza los trienios acumulados por el empleado en la fecha (año o mes) seleccionada en la
dimensión “tiempo”.",paragraph,121,26,5511,5632
info_cubo_PTGAS_v21.md,"=== MEDIDAS ===

** Número de PTGAS **
Número de efectivos de Personal Técnico, de Gestión, de Administración y Servicios (PTGAS) que constan en bases de datos de personal con contrato activo a la fecha de consulta.",sentence,215,44,0,215
info_cubo_PTGAS_v21.md,"Observaciones:

>IMPORTANTE: se debe utilizar la dimensión TIEMPO (año o mes) para filtrar el número de efectivos en un
periodo o fecha concreta.",sentence,145,29,215,360
info_cubo_PTGAS_v21.md,"Se incluye la totalidad de efectivos, estén ocupando o no su puesto.",sentence,68,14,361,429
info_cubo_PTGAS_v21.md,"=== DIMENSIONES ===

## DIMENSION: Compatibilidad ##

Atributos:
• Concedida (S/N):
Permite clasificar los datos en función de si los empleados tienen concedida (S) o no (N), por esta institución, compatibilidad con otras actividades públicas o privadas.",sentence,254,51,430,684
info_cubo_PTGAS_v21.md,"## DIMENSION: Contrato ##

Atributos:
• Categoría Cuerpo Escala:
Permite clasificar los datos en función de la categoría/cuerpo/escala a la que pertenecen los empleados.",sentence,169,30,686,855
info_cubo_PTGAS_v21.md,"• Dedicación:
Identifica el tipo de dedicación que tienen los empleados.",sentence,72,13,857,929
info_cubo_PTGAS_v21.md,">Valores posibles: tiempo completo, tiempo parcial.",sentence,51,10,931,982
info_cubo_PTGAS_v21.md,"• Grado complemento:
Permite agrupar los datos en función del grado de complemento personal consolidado por los empleados.",sentence,122,20,984,1106
info_cubo_PTGAS_v21.md,">Nota: en caso de que el empleado no haya consolidado grado de complemento se indica ""No informado"".",sentence,100,22,1108,1208
info_cubo_PTGAS_v21.md,"• Grupo:
Permite agrupar los datos en función del grupo de pertenencia laboral de los empleados.",sentence,96,18,1210,1306
info_cubo_PTGAS_v21.md,">Valores posibles: A1, A2, C1, C2, LA, LB, LC, LD.",sentence,50,20,1308,1358
info_cubo_PTGAS_v21.md,"• Régimen Jurídico:
Permite agrupar a los empleados en función del régimen jurídico en el que se adscribe su nombramiento o contrato.",sentence,133,24,1360,1493
info_cubo_PTGAS_v21.md,">Valores posibles: funcionario, laboral.",sentence,40,8,1495,1535
info_cubo_PTGAS_v21.md,"• Situación Administrativa:
Permite agrupar los empleados en función de la situación administrativa en la que se encuentren.",sentence,124,20,1537,1661
info_cubo_PTGAS_v21.md,">Ejemplos: servicio activo, excedencia, suspensión de contrato, servicios especiales.",sentence,85,15,1663,1748
info_cubo_PTGAS_v21.md,"• Tipo personal:
Permite agrupar los empleados en función de la modalidad de régimen jurídico.",sentence,94,17,1750,1844
info_cubo_PTGAS_v21.md,">Valores posibles: de carrera, interino, indefinido fijo, temporal, en prácticas.",sentence,81,17,1846,1927
info_cubo_PTGAS_v21.md,"## DIMENSION: Fecha de actualización ##

Notas generales:
- Indica la fecha de la última recarga de datos.",sentence,106,23,1929,2035
info_cubo_PTGAS_v21.md,Habitualmente es el domingo anterior a la consulta de datos.,sentence,60,11,2037,2097
info_cubo_PTGAS_v21.md,"## DIMENSION: Persona ##

Atributos:
• Edad:
Permite agrupar los empleados en función de su edad a fecha 31 de diciembre del año seleccionado.",sentence,142,30,2098,2240
info_cubo_PTGAS_v21.md,">Valores posibles: 21-25, 26-30, 31-35, 36-40, 41-45, 46-50, 51-55, 56-60, 61-65,>65.",sentence,85,25,2242,2327
info_cubo_PTGAS_v21.md,"• Nivel Titulación:
Permite clasificar los datos en función del nivel de titulación de los empleados.",sentence,101,18,2329,2430
info_cubo_PTGAS_v21.md,">Valores posibles: Doctor, Máster, Grado, Licenciados o equivalentes, Diplomados o equivalentes, Bachiller
Superior o equivalente, Bachiller elemental o equivalente, Enseñanza primaria o equivalente.",sentence,199,33,2432,2631
info_cubo_PTGAS_v21.md,"• País Nacionalidad:
Permite clasificar los datos en función del país de nacionalidad legal del personal.",sentence,105,18,2633,2738
info_cubo_PTGAS_v21.md,"• Residencia:
Identifica el país, la comunidad autónoma, la provincia o la población de residencia familiar informada por lo empleados.",sentence,135,24,2740,2875
info_cubo_PTGAS_v21.md,"• Sexo:
Permite clasificar los empleados en función de su sexo.",sentence,63,13,2877,2940
info_cubo_PTGAS_v21.md,"## DIMENSION: Puesto ##

Atributos:
• Categoría:
Permite clasificar los datos en función de la categoría del puesto que ocupan los empleados.",sentence,141,28,2942,3083
info_cubo_PTGAS_v21.md,"• Centro:
Permite clasificar los datos en función del centro al que están adscritos los empleados.",sentence,98,18,3085,3183
info_cubo_PTGAS_v21.md,"• Centro Localidad:
Permite clasificar los datos en función de la localidad donde se sitúa el centro al que están adscritos los empleados.",sentence,138,25,3185,3323
info_cubo_PTGAS_v21.md,"• Especialidad RPT:
Permite clasificar a los empleados en función de la especialidad a la que está asignado en la Relación de Puestos de Trabajo el puesto que ocupan.",sentence,166,31,3325,3491
info_cubo_PTGAS_v21.md,">Valores posibles: Área de Administración y Servicios Generales, Área Técnica, de Mantenimiento y Oficios,
Apoyo a la Docencia e Investigación y Laboratorios, Fuera RPT.",sentence,169,31,3493,3662
info_cubo_PTGAS_v21.md,"• PTGAS de Investigación (S/N):
Permite distinguir si los efectivos de PTGAS se remuneran con cargo a proyectos de investigación (S) o no (N)

>Observación: se considerarán PTGAS de Investigación si ocupan puestos asignados a los programas 148I,
171I, 417-I, 423-I ó 425-I.",sentence,273,56,3664,3937
info_cubo_PTGAS_v21.md,"• Unidad:
Permite clasificar los datos en función de la unidad a la que están adscritos los empleados.",sentence,102,20,3939,4041
info_cubo_PTGAS_v21.md,"## DIMENSION: Sindicato ##

Notas generales:
- Permite clasificar a los empleados en función de si tienen concedida o no algún tipo de reducción horaria par el desempeño de tareas sindicales.",sentence,191,36,4043,4234
info_cubo_PTGAS_v21.md,">Nota: si los empleados tienen concedida reducción se detalla la denominación del sindicato y si no tienen
concedida reducción figura el valor “No Informado”.",sentence,158,29,4236,4394
info_cubo_PTGAS_v21.md,"Atributos:
• Reducción:
Identifica el porcentaje de reducción horaria o número de horas lectivas que se reducen por el desempeño d tareas sindicales, figuran con el valor “No informado”.",sentence,186,35,4396,4582
info_cubo_PTGAS_v21.md,">Nota: si el empleado no tiene concedida reducción horaria, figura con el valor “Sin reducción”.",sentence,96,21,4584,4680
info_cubo_PTGAS_v21.md,"## DIMENSION: TIEMPO ##

Notas generales:
- Permite ubicar en el tiempo la relación del personal con la UZ.",sentence,107,24,4682,4789
info_cubo_PTGAS_v21.md,"Se pueden desglosar los datos según el año o mes: • MES: se incluyen los efectivos existentes a fecha último día del mes seleccionado (si se trata de un m en curso, se incluyen los efectivos existentes a la fecha de la última carga).",sentence,233,50,4791,5024
info_cubo_PTGAS_v21.md,"• AÑO: se acumulan los efectivos existentes a fecha último día de todos los meses del año seleccionad (si el año seleccionado es un año en curso, se acumulan los efectivos existentes a fecha último día de los meses anteriores y para el mes en curso los efectivos existentes a la fecha de la última carga).",sentence,305,61,5025,5330
info_cubo_PTGAS_v21.md,"## DIMENSION: Tramos ##

Atributos:
• Gestión Trienios:
Permite clasificar los datos en función del número de trienios o tramos de gestión que tienen reconocidos los empleados.",sentence,176,33,5331,5507
info_cubo_PTGAS_v21.md,">Nota: contabiliza los trienios acumulados por el empleado en la fecha (año o mes) seleccionada en la
dimensión “tiempo”.",sentence,121,26,5509,5630
info_cubo_puesto_v14.md,"=== MEDIDAS ===

** Número de puestos **
Número de puestos de trabajo existentes en la UZ. Se incluyen todos los puestos de RPT y los puestos fuera d RPT que estén ocupados.",section,174,37,0,174
info_cubo_puesto_v14.md,=== DIMENSIONES ===,section,20,3,175,195
info_cubo_puesto_v14.md,"## DIMENSION: Centro ##

Notas generales:
- Permite clasificar los datos en función del centro al que están adscritos los puestos.",section,131,26,196,327
info_cubo_puesto_v14.md,"## DIMENSION: Dedicación del puesto ##

Notas generales:
- Identifica el tipo de dedicación de los puestos de trabajo.

>Valores posibles: tiempo completo, tiempo parcial, tiempo parcial 6 horas, tiempo parcial 4 horas, tiempo
parcial 3 horas, conjunta completa, conjunta parcial (es la dedicación del personal de ciencias de la salud), colaborador extraordinario.",section,365,70,328,693
info_cubo_puesto_v14.md,"## DIMENSION: Departamento ##

Notas generales:
- Permite clasificar los datos en función del departamento al que están adscritos los puestos.",section,143,26,694,837
info_cubo_puesto_v14.md,"## DIMENSION: Fecha de actualización ##

Notas generales:
- Indica la fecha de la última recarga de datos. Habitualmente es el domingo anterior a la consulta de datos.",section,168,34,838,1006
info_cubo_puesto_v14.md,"## DIMENSION: Grupos puesto ##

Notas generales:
- Permite agrupar los puestos de trabajo en función del grupo de pertenencia de los empleados que pueden desempeñarlos con carácter definitivo.",section,193,34,1007,1200
info_cubo_puesto_v14.md,"## DIMENSION: Nivel complemento ##

Notas generales:
- Permite agrupar los puestos de trabajo en función del nivel de complemento que tienen asignado.",section,151,28,1201,1352
info_cubo_puesto_v14.md,"## DIMENSION: Puesto ##

Notas generales:
- Permite agrupar los puestos de trabajo según su denominación.",section,106,21,1353,1459
info_cubo_puesto_v14.md,"## DIMENSION: Puesto Categoría ##

Notas generales:
- Permite agrupar los datos en función de la categoría de los puestos de trabajo.",section,134,27,1460,1594
info_cubo_puesto_v14.md,"## DIMENSION: Puesto Desempeño ##

Notas generales:
- Permite agrupar los puestos de trabajo en función de la persona que lo está desempeñando.

>Valores posibles: Titular, No Titular, Sin ocupante.
>TITULAR: la persona que desempeña el puesto es su titular.
>NO TITULAR: quien desempeña el puesto es una persona distinta de su titular. En caso de que el puesto sea
fuera de RPT, figurará siempre en esta dimensión el valor “no titular”, porque los puestos fuera de RPT no tienen titular, pero sí una persona que lo desempeña.

>SIN OCUPANTE: el puesto no lo desempeña ninguna persona.",section,586,122,1595,2181
info_cubo_puesto_v14.md,"## DIMENSION: Puesto Situación ##

Notas generales:
- Permite agrupar los puestos de trabajo según su situación.

>Valores posibles: ocupado por el titular, vacante técnica, vacante efectiva, fuera de RPT
>OCUPADO POR EL TITULAR: puesto de RPT asignado con carácter definitivo a un empleado. A su vez puede
estar desempeñado por una persona distinta del titular del puesto (ver dimensión “puesto desempeño”). En estos casos habrá dos personas con vinculación a ese puesto: la titular y quien lo desempeñe –o más, según l casos, por ejemplo, si un sustituto es a su vez sustituido por una situación de ILT-.

>VACANTE: puesto de RPT que no está asignado con carácter definitivo a nadie, no tiene titular. Se distingue
dos casos: cuando el puesto está desempeñado temporalmente por un empleado (vacante TÉCNICA) y cuand nadie desempeña ese puesto (vacante EFECTIVA)

>FUERA DE RPT: puestos fuera de plantilla.",section,908,180,2182,3090
info_cubo_puesto_v14.md,"## DIMENSION: Puesto de Investigación (S/N) ##

Notas generales:
- Permite distinguir si los puestos se remuneran con cargo a proyectos de investigación (S) o no (N).

>Observación: se considerarán Puesto de Investigación si están asignados a los programas 148I, 171I, 417-I,
423-I, 425-I ó 541-I.",section,298,64,3091,3389
info_cubo_puesto_v14.md,"## DIMENSION: Régimen Jurídico ##

Notas generales:
- Permite agrupar los puestos de trabajo en función del régimen jurídico al que se adscribe su cobertura.

>Valores posibles: funcionario, laboral, atípico (es el caso de los colaboradores extraordinarios y el de los
eméritos), contratado administrativo.",section,307,57,3390,3697
info_cubo_puesto_v14.md,"## DIMENSION: TIEMPO ##

Notas generales:
- Permite ubicar en el tiempo la existencia de los puestos de trabajo. Se pueden desglosar los datos según el a o el mes: • MES: se incluyen los puestos existentes a fecha último día del mes seleccionado (si se trata de un mes curso, se incluyen los puestos existentes a la fecha de la última carga). • AÑO: se acumulan los puestos existentes a fecha último día de todos los meses del año seleccionado ( el año seleccionado es un año en curso, se acumulan los puestos existentes a fecha último día de los meses anteriores y para el mes en curso los puestos existentes a la fecha de la última carga).",section,642,134,3698,4340
info_cubo_puesto_v14.md,"## DIMENSION: Tipo puesto ##

Notas generales:
- Permite distinguir si los puestos de trabajo son de PDI o de PAS.",section,115,26,4341,4456
info_cubo_puesto_v14.md,"## DIMENSION: Unidad ##

Notas generales:
- Permite clasificar los datos en función de la unidad a la que están adscritos los puestos.",section,135,28,4457,4592
info_cubo_puesto_v14.md,"## DIMENSION: Vinculado Instituciones Sanitarias ##

Notas generales:
- Permite identificar si los puestos están vinculados a instituciones sanitarias (S) o no (N).",section,166,32,4593,4759
info_cubo_puesto_v14.md,=== MEDIDAS ===,paragraph,15,3,0,15
info_cubo_puesto_v14.md,"** Número de puestos **
Número de puestos de trabajo existentes en la UZ. Se incluyen todos los puestos de RPT y los puestos fuera d RPT que estén ocupados.",paragraph,156,34,17,173
info_cubo_puesto_v14.md,=== DIMENSIONES ===,paragraph,19,3,175,194
info_cubo_puesto_v14.md,## DIMENSION: Centro ##,paragraph,23,7,196,219
info_cubo_puesto_v14.md,"Notas generales:
- Permite clasificar los datos en función del centro al que están adscritos los puestos.",paragraph,105,19,221,326
info_cubo_puesto_v14.md,## DIMENSION: Dedicación del puesto ##,paragraph,38,9,328,366
info_cubo_puesto_v14.md,"Notas generales:
- Identifica el tipo de dedicación de los puestos de trabajo.",paragraph,78,15,368,446
info_cubo_puesto_v14.md,">Valores posibles: tiempo completo, tiempo parcial, tiempo parcial 6 horas, tiempo parcial 4 horas, tiempo
parcial 3 horas, conjunta completa, conjunta parcial (es la dedicación del personal de ciencias de la salud), colaborador extraordinario.",paragraph,244,46,448,692
info_cubo_puesto_v14.md,## DIMENSION: Departamento ##,paragraph,29,7,694,723
info_cubo_puesto_v14.md,"Notas generales:
- Permite clasificar los datos en función del departamento al que están adscritos los puestos.",paragraph,111,19,725,836
info_cubo_puesto_v14.md,## DIMENSION: Fecha de actualización ##,paragraph,39,9,838,877
info_cubo_puesto_v14.md,"Notas generales:
- Indica la fecha de la última recarga de datos. Habitualmente es el domingo anterior a la consulta de datos.",paragraph,126,25,879,1005
info_cubo_puesto_v14.md,## DIMENSION: Grupos puesto ##,paragraph,30,8,1007,1037
info_cubo_puesto_v14.md,"Notas generales:
- Permite agrupar los puestos de trabajo en función del grupo de pertenencia de los empleados que pueden desempeñarlos con carácter definitivo.",paragraph,160,26,1039,1199
info_cubo_puesto_v14.md,## DIMENSION: Nivel complemento ##,paragraph,34,8,1201,1235
info_cubo_puesto_v14.md,"Notas generales:
- Permite agrupar los puestos de trabajo en función del nivel de complemento que tienen asignado.",paragraph,114,20,1237,1351
info_cubo_puesto_v14.md,## DIMENSION: Puesto ##,paragraph,23,7,1353,1376
info_cubo_puesto_v14.md,"Notas generales:
- Permite agrupar los puestos de trabajo según su denominación.",paragraph,80,14,1378,1458
info_cubo_puesto_v14.md,## DIMENSION: Puesto Categoría ##,paragraph,33,8,1460,1493
info_cubo_puesto_v14.md,"Notas generales:
- Permite agrupar los datos en función de la categoría de los puestos de trabajo.",paragraph,98,19,1495,1593
info_cubo_puesto_v14.md,## DIMENSION: Puesto Desempeño ##,paragraph,33,8,1595,1628
info_cubo_puesto_v14.md,"Notas generales:
- Permite agrupar los puestos de trabajo en función de la persona que lo está desempeñando.",paragraph,108,20,1630,1738
info_cubo_puesto_v14.md,">Valores posibles: Titular, No Titular, Sin ocupante.
>TITULAR: la persona que desempeña el puesto es su titular.
>NO TITULAR: quien desempeña el puesto es una persona distinta de su titular. En caso de que el puesto sea
fuera de RPT, figurará siempre en esta dimensión el valor “no titular”, porque los puestos fuera de RPT no tienen titular, pero sí una persona que lo desempeña.",paragraph,381,82,1740,2121
info_cubo_puesto_v14.md,>SIN OCUPANTE: el puesto no lo desempeña ninguna persona.,paragraph,57,12,2123,2180
info_cubo_puesto_v14.md,## DIMENSION: Puesto Situación ##,paragraph,33,8,2182,2215
info_cubo_puesto_v14.md,"Notas generales:
- Permite agrupar los puestos de trabajo según su situación.",paragraph,77,14,2217,2294
info_cubo_puesto_v14.md,">Valores posibles: ocupado por el titular, vacante técnica, vacante efectiva, fuera de RPT
>OCUPADO POR EL TITULAR: puesto de RPT asignado con carácter definitivo a un empleado. A su vez puede
estar desempeñado por una persona distinta del titular del puesto (ver dimensión “puesto desempeño”). En estos casos habrá dos personas con vinculación a ese puesto: la titular y quien lo desempeñe –o más, según l casos, por ejemplo, si un sustituto es a su vez sustituido por una situación de ILT-.",paragraph,492,100,2296,2788
info_cubo_puesto_v14.md,">VACANTE: puesto de RPT que no está asignado con carácter definitivo a nadie, no tiene titular. Se distingue
dos casos: cuando el puesto está desempeñado temporalmente por un empleado (vacante TÉCNICA) y cuand nadie desempeña ese puesto (vacante EFECTIVA)",paragraph,255,48,2790,3045
info_cubo_puesto_v14.md,>FUERA DE RPT: puestos fuera de plantilla.,paragraph,42,10,3047,3089
info_cubo_puesto_v14.md,## DIMENSION: Puesto de Investigación (S/N) ##,paragraph,46,12,3091,3137
info_cubo_puesto_v14.md,"Notas generales:
- Permite distinguir si los puestos se remuneran con cargo a proyectos de investigación (S) o no (N).",paragraph,118,26,3139,3257
info_cubo_puesto_v14.md,">Observación: se considerarán Puesto de Investigación si están asignados a los programas 148I, 171I, 417-I,
423-I, 425-I ó 541-I.",paragraph,129,26,3259,3388
info_cubo_puesto_v14.md,## DIMENSION: Régimen Jurídico ##,paragraph,33,8,3390,3423
info_cubo_puesto_v14.md,"Notas generales:
- Permite agrupar los puestos de trabajo en función del régimen jurídico al que se adscribe su cobertura.",paragraph,122,22,3425,3547
info_cubo_puesto_v14.md,">Valores posibles: funcionario, laboral, atípico (es el caso de los colaboradores extraordinarios y el de los
eméritos), contratado administrativo.",paragraph,147,27,3549,3696
info_cubo_puesto_v14.md,## DIMENSION: TIEMPO ##,paragraph,23,7,3698,3721
info_cubo_puesto_v14.md,"Notas generales:
- Permite ubicar en el tiempo la existencia de los puestos de trabajo. Se pueden desglosar los datos según el a o el mes: • MES: se incluyen los puestos existentes a fecha último día del mes seleccionado (si se trata de un mes curso, se incluyen los puestos existentes a la fecha de la última carga). • AÑO: se acumulan los puestos existentes a fecha último día de todos los meses del año seleccionado ( el año seleccionado es un año en curso, se acumulan los puestos existentes a fecha último día de los meses anteriores y para el mes en curso los puestos existentes a la fecha de la última carga).",paragraph,616,127,3723,4339
info_cubo_puesto_v14.md,## DIMENSION: Tipo puesto ##,paragraph,28,8,4341,4369
info_cubo_puesto_v14.md,"Notas generales:
- Permite distinguir si los puestos de trabajo son de PDI o de PAS.",paragraph,84,18,4371,4455
info_cubo_puesto_v14.md,## DIMENSION: Unidad ##,paragraph,23,7,4457,4480
info_cubo_puesto_v14.md,"Notas generales:
- Permite clasificar los datos en función de la unidad a la que están adscritos los puestos.",paragraph,109,21,4482,4591
info_cubo_puesto_v14.md,## DIMENSION: Vinculado Instituciones Sanitarias ##,paragraph,51,9,4593,4644
info_cubo_puesto_v14.md,"Notas generales:
- Permite identificar si los puestos están vinculados a instituciones sanitarias (S) o no (N).",paragraph,111,23,4646,4757
info_cubo_puesto_v14.md,"=== MEDIDAS ===

** Número de puestos **
Número de puestos de trabajo existentes en la UZ.",sentence,90,20,0,90
info_cubo_puesto_v14.md,Se incluyen todos los puestos de RPT y los puestos fuera d RPT que estén ocupados.,sentence,82,17,90,172
info_cubo_puesto_v14.md,"=== DIMENSIONES ===

## DIMENSION: Centro ##

Notas generales:
- Permite clasificar los datos en función del centro al que están adscritos los puestos.",sentence,151,29,173,324
info_cubo_puesto_v14.md,"## DIMENSION: Dedicación del puesto ##

Notas generales:
- Identifica el tipo de dedicación de los puestos de trabajo.",sentence,118,24,326,444
info_cubo_puesto_v14.md,">Valores posibles: tiempo completo, tiempo parcial, tiempo parcial 6 horas, tiempo parcial 4 horas, tiempo
parcial 3 horas, conjunta completa, conjunta parcial (es la dedicación del personal de ciencias de la salud), colaborador extraordinario.",sentence,244,46,446,690
info_cubo_puesto_v14.md,"## DIMENSION: Departamento ##

Notas generales:
- Permite clasificar los datos en función del departamento al que están adscritos los puestos.",sentence,142,26,692,834
info_cubo_puesto_v14.md,"## DIMENSION: Fecha de actualización ##

Notas generales:
- Indica la fecha de la última recarga de datos.",sentence,106,23,836,942
info_cubo_puesto_v14.md,Habitualmente es el domingo anterior a la consulta de datos.,sentence,60,11,944,1004
info_cubo_puesto_v14.md,"## DIMENSION: Grupos puesto ##

Notas generales:
- Permite agrupar los puestos de trabajo en función del grupo de pertenencia de los empleados que pueden desempeñarlos con carácter definitivo.",sentence,192,34,1005,1197
info_cubo_puesto_v14.md,"## DIMENSION: Nivel complemento ##

Notas generales:
- Permite agrupar los puestos de trabajo en función del nivel de complemento que tienen asignado.",sentence,150,28,1199,1349
info_cubo_puesto_v14.md,"## DIMENSION: Puesto ##

Notas generales:
- Permite agrupar los puestos de trabajo según su denominación.",sentence,105,21,1351,1456
info_cubo_puesto_v14.md,"## DIMENSION: Puesto Categoría ##

Notas generales:
- Permite agrupar los datos en función de la categoría de los puestos de trabajo.",sentence,133,27,1458,1591
info_cubo_puesto_v14.md,"## DIMENSION: Puesto Desempeño ##

Notas generales:
- Permite agrupar los puestos de trabajo en función de la persona que lo está desempeñando.",sentence,143,28,1593,1736
info_cubo_puesto_v14.md,">Valores posibles: Titular, No Titular, Sin ocupante.",sentence,53,12,1738,1791
info_cubo_puesto_v14.md,>TITULAR: la persona que desempeña el puesto es su titular.,sentence,59,13,1793,1852
info_cubo_puesto_v14.md,>NO TITULAR: quien desempeña el puesto es una persona distinta de su titular.,sentence,77,16,1853,1930
info_cubo_puesto_v14.md,"En caso de que el puesto sea
fuera de RPT, figurará siempre en esta dimensión el valor “no titular”, porque los puestos fuera de RPT no tienen titular, pero sí una persona que lo desempeña.",sentence,189,41,1931,2120
info_cubo_puesto_v14.md,>SIN OCUPANTE: el puesto no lo desempeña ninguna persona.,sentence,57,12,2121,2178
info_cubo_puesto_v14.md,"## DIMENSION: Puesto Situación ##

Notas generales:
- Permite agrupar los puestos de trabajo según su situación.",sentence,112,22,2180,2292
info_cubo_puesto_v14.md,">Valores posibles: ocupado por el titular, vacante técnica, vacante efectiva, fuera de RPT
>OCUPADO POR EL TITULAR: puesto de RPT asignado con carácter definitivo a un empleado.",sentence,177,35,2294,2471
info_cubo_puesto_v14.md,"A su vez puede
estar desempeñado por una persona distinta del titular del puesto (ver dimensión “puesto desempeño”).",sentence,116,23,2473,2589
info_cubo_puesto_v14.md,"En estos casos habrá dos personas con vinculación a ese puesto: la titular y quien lo desempeñe –o más, según l casos, por ejemplo, si un sustituto es a su vez sustituido por una situación de ILT-.",sentence,197,42,2590,2787
info_cubo_puesto_v14.md,">VACANTE: puesto de RPT que no está asignado con carácter definitivo a nadie, no tiene titular.",sentence,95,20,2788,2883
info_cubo_puesto_v14.md,"Se distingue
dos casos: cuando el puesto está desempeñado temporalmente por un empleado (vacante TÉCNICA) y cuand nadie desempeña ese puesto (vacante EFECTIVA)

>FUERA DE RPT: puestos fuera de plantilla.",sentence,203,38,2885,3088
info_cubo_puesto_v14.md,"## DIMENSION: Puesto de Investigación (S/N) ##

Notas generales:
- Permite distinguir si los puestos se remuneran con cargo a proyectos de investigación (S) o no (N).",sentence,166,38,3089,3255
info_cubo_puesto_v14.md,">Observación: se considerarán Puesto de Investigación si están asignados a los programas 148I, 171I, 417-I,
423-I, 425-I ó 541-I.",sentence,129,26,3257,3386
info_cubo_puesto_v14.md,"## DIMENSION: Régimen Jurídico ##

Notas generales:
- Permite agrupar los puestos de trabajo en función del régimen jurídico al que se adscribe su cobertura.",sentence,157,30,3388,3545
info_cubo_puesto_v14.md,">Valores posibles: funcionario, laboral, atípico (es el caso de los colaboradores extraordinarios y el de los
eméritos), contratado administrativo.",sentence,147,27,3547,3694
info_cubo_puesto_v14.md,"## DIMENSION: TIEMPO ##

Notas generales:
- Permite ubicar en el tiempo la existencia de los puestos de trabajo.",sentence,112,24,3696,3808
info_cubo_puesto_v14.md,"Se pueden desglosar los datos según el a o el mes: • MES: se incluyen los puestos existentes a fecha último día del mes seleccionado (si se trata de un mes curso, se incluyen los puestos existentes a la fecha de la última carga).",sentence,229,50,3810,4039
info_cubo_puesto_v14.md,"• AÑO: se acumulan los puestos existentes a fecha último día de todos los meses del año seleccionado ( el año seleccionado es un año en curso, se acumulan los puestos existentes a fecha último día de los meses anteriores y para el mes en curso los puestos existentes a la fecha de la última carga).",sentence,298,60,4040,4338
info_cubo_puesto_v14.md,"## DIMENSION: Tipo puesto ##

Notas generales:
- Permite distinguir si los puestos de trabajo son de PDI o de PAS.",sentence,114,26,4339,4453
info_cubo_puesto_v14.md,"## DIMENSION: Unidad ##

Notas generales:
- Permite clasificar los datos en función de la unidad a la que están adscritos los puestos.",sentence,134,28,4455,4589
info_cubo_puesto_v14.md,"## DIMENSION: Vinculado Instituciones Sanitarias ##

Notas generales:
- Permite identificar si los puestos están vinculados a instituciones sanitarias (S) o no (N).",sentence,164,32,4591,4755
info_cubo_rendimiento_v21.md,"=== MEDIDAS ===

** Tasa de Éxito **
Relación porcentual entre el número total de créditos superados por los estudiantes en un estudio y el número total d créditos presentados a examen. Observaciones:

>Se cuentan los créditos presentados una sola vez en el curso académico aunque se haya presentado a más de un
convocatoria en ese mismo curso.

>Se excluyen del cálculo los créditos de asignaturas cursadas por estudiantes de la UZ en otras universidades en virtu
de un programa de intercambio, los créditos de asignaturas del plan matriculados por estudiantes de programas d movilidad de otras universidades, los créditos matriculados en asignaturas que no son las del plan del alumno y l créditos reconocidos, adaptados o convalidados.

** Tasa de Rendimiento **
Relación porcentual entre el número total de créditos superados por los estudiantes en un estudio y el número total d créditos matriculados (evaluados). Observaciones:

>Se consideran créditos matriculados aquellos que han sido evaluados, es decir, que han recibido calificación (presentad
o no presentado) en actas.

>Se excluyen del cálculo los créditos de asignaturas cursadas por estudiantes de la UZ en otras universidades en virtu
de un programa de intercambio, los créditos de asignaturas del plan matriculados por estudiantes de programas d movilidad de otras universidades, los créditos matriculados en asignaturas que no son las del plan del alumno y l créditos reconocidos, adaptados o convalidados.

** Tasa de Evaluación **
Relación porcentual entre el número total de créditos presentados a examen por los estudiantes en un estudio y número total de créditos matriculados (evaluados). Observaciones:

>Se cuentan los créditos presentados una sola vez en el curso académico aunque se haya presentado a más de un
convocatoria en ese mismo curso.

>Se consideran créditos matriculados aquellos que han sido evaluados, es decir, que han recibido calificación (presentad
o no presentado) en actas.

>Se excluyen del cálculo los créditos de asignaturas cursadas por estudiantes de la UZ en otras universidades en virtu
de un programa de intercambio, los créditos de asignaturas del plan matriculados por estudiantes de programas d movilidad de otras universidades, los créditos matriculados en asignaturas que no son las del plan del alumno y l créditos reconocidos, adaptados o convalidados.

** Créditos Evaluados **
Incluye los créditos matriculados por los estudiantes que han sido calificados (los créditos que no han sido calificados n se contabilizan). Observaciones:

>Se tienen en cuenta los créditos que han recibido calificación (presentado o no presentado) en actas, lo cual deb
tenerse presente sobre todo en los cursos académicos abiertos.

>No se incluyen los créditos reconocidos.

** Créditos Superados **
Créditos de asignaturas cuyos resultados de examen han obtenido cualquiera de las siguientes calificaciones: Aprobad Aprobado por compensación, Apto, Matrícula de Honor, Notable, Sobresaliente.

>Nota: no se incluyen los créditos adaptados, convalidados o reconocidos.

** Créditos Presentados **
Suma de los créditos incluidos en las medidas ""créditos superados"" y ""créditos suspendidos"".

>Nota: se cuentan los créditos presentados una sola vez en el curso académico aunque el estudiante se haya presentad
a más de una convocatoria en ese mismo curso.

** Créditos Suspendidos **
Créditos de asignaturas cuyos resultados de examen han obtenido cualquiera de las siguientes calificaciones: S=Suspens SC=Suspenso compensable.

>Nota: no se incluyen los créditos adaptados, convalidados o reconocidos.

** Alumnos Evaluados **
Contabiliza el número de estudiantes que han recibido calificación en las asignaturas matriculadas. Observaciones:

>Se considera evaluado si han recibido calificación (presentado o no presentado) en actas. Debe tenerse presente que e
los cursos académicos abiertos puede haber créditos pendientes de calificar.

>Nota: las asignaturas adaptadas, convalidadas o reconocidas no contabilizan en este cálculo.

** Alumnos Superados **
Contabiliza el número de estudiantes matriculados en asignaturas cuyos resultados en actas incluye cualquiera de l siguientes calificaciones: Aprobado, Aprobado por compensación, Apto, Matrícula de Honor, Notable, Sobresalient Evaluación Positiva.

>Nota: las asignaturas adaptadas, convalidadas o reconocidas no contabilizan en este cálculo.

** Alumnos Presentados **
Contabiliza el número de estudiantes matriculados en asignaturas cuyos resultados en actas incluye cualquiera de l siguientes calificaciones: Aprobado, Aprobado por compensación, Apto, Matrícula de Honor, Notable, Sobresalient Evaluación Positiva, No Apto, Suspenso, Evaluación Negativa.

** Créditos Reconocidos **
Créditos que, habiendo sido obtenidos con anterioridad en una enseñanza oficial de cualquier universidad, so computados en enseñanzas de la UZ a efectos de la obtención de un título oficial de Grado y de Máster. También se incluyen en este cómputo los créditos de asignaturas que han sido adaptadas y los créditos convalidados, decir, los que el alumno consigue para la titulación en la que está matriculado, por superación de conocimient académicos previos o realización de actividades que tienen reconocimiento académico. En el caso de crédit convalidados suspensos, se mantiene la calificación.

** Nota Media de Admisión **
Es la media de las notas de admisión de los estudiantes evaluados en el curso académico seleccionado.

>Nota: los estudiantes que acceden al plan por un procedimiento distinto al de preinscripción y los que accedieron p
preinscripción con anterioridad al curso 2010/11 no tienen informada esta variable.

** Media de Convocatorias Consumidas **
Es la media de las convocatorias que ha consumido un estudiante para una asignatura, una vez que la ha superado. S consigna en el curso académico en el que el estudiante supera la asignatura. Es, por tanto, un indicador del número d convocatorias que el estudiante consume hasta que supera la asignatura.",section,6019,1041,0,6019
info_cubo_rendimiento_v21.md,=== DIMENSIONES ===,section,20,3,6020,6040
info_cubo_rendimiento_v21.md,"## DIMENSION: Acceso ##

Atributos:
• Estudio previo:
Identifica la clase de estudio cursado anteriormente por los estudiantes, que les da acceso a la Universidad, de acuerd con los requisitos establecidos por la legislación vigente.

>Valores posibles: Pruebas de Acceso, COU sin PAU, FP, Titulados Universitarios, Mayores de 25, Mayores de 40, Mayor
de 45.

>Los estudiantes procedentes de Bachillerato se incluyen en “Pruebas de Acceso”. Los estudiantes procedentes d
Ciclos Formativos de Grado Superior se incluyen en “FP”, aunque se hayan presentado a la fase específica de la EvAU

>Nota: el valor “No informado” se aplica a estudiantes procedentes de adaptaciones por extinción de planes de
estudios o que no han accedido a la titulación por procedimientos de preinscripción.

• Nuevo Ingreso (S/N):
Indica si los estudiantes son de nuevo ingreso (S) o no (N) en el curso académico que se seleccione. Se considera que e estudiante es de nuevo ingreso si consume alguna de las plazas ofertadas para un año y plan (no se consideran matriculados de nuevo ingreso los que acceden a un estudio por el procedimiento de cambio de estudios, traslado de expediente, adaptación al grado, o los que anulan la matrícula).

• Rango de Nota de Admisión:
Permite clasificar los estudiantes en función del rango de su nota de admisión. Observaciones:

>El valor “No informado” se aplica a estudiantes que acceden al plan por un procedimiento distinto al de preinscripció
y los que accedieron por preinscripción con anterioridad al curso 2010-11.

>Los rangos inferiores a 5 corresponden a las notas de admisión de estudiantes que acceden por el cupo de Titulados.",section,1655,318,6041,7696
info_cubo_rendimiento_v21.md,"## DIMENSION: Alumno ##

Atributos:
• País Nacionalidad:
Permite clasificar los datos en función del país de nacionalidad legal de los estudiantes.

• Rango de Edad:
Permite agrupar los rangos de edad de los estudiantes en función de su edad a fecha 31 de diciembre del curso académico en que están matriculados.

>Valores posibles: 18 años o menos, 19, 20, 21, 22, 23, 24, 25, 26, 27, 28, 29, 30 a 34, 35 a 39, 40 a 44, 45 a 49, 50 a 54
55 a 59, 60 a 64, 65 años o más.

• Residencia Familiar:
Identifica el país, la comunidad autónoma, la provincia o la población de residencia familiar indicada por el alumno en curso académico en que se matricula.

• Sexo:
Permite agrupar los estudiantes en función de su sexo.",section,716,168,7697,8413
info_cubo_rendimiento_v21.md,"## DIMENSION: Asignatura ##

Notas generales:
- Permite clasificar los datos en función de la asignatura (código y denominación) en que se matriculan los estudiantes.

Atributos:
• Clase:
Permite clasificar los datos en función de la clase de asignatura (formación básica, obligatoria, optativa, libre elección, troncal, trabajo fin de grado, trabajo fin de máster, prácticas externas, complementos de formación, actividades académicas complementarias), tal como viene identificada en el plan de estudios.",section,506,93,8414,8920
info_cubo_rendimiento_v21.md,"## DIMENSION: CURSO ACADÉMICO ##

Notas generales:
- Identifica los diferentes cursos académicos (por ejemplo 2023/24).",section,120,23,8921,9041
info_cubo_rendimiento_v21.md,"## DIMENSION: Centro ##

Notas generales:
- Permite clasificar los datos en función del centro (código y denominación) de matrícula de los estudiantes.

Atributos:
• Campus:
Permite clasificar los datos en función del campus en el que se ubica el centro de matrícula de los estudiantes.

• Localidad:
Permite clasificar los datos en función de la localidad a la que pertenece el centro de matrícula de los estudiantes.

• Tipo:
Permite clasificar los datos en función del tipo de centro (facultad, escuela universitaria, centro adscrito, etc.) en que s matriculan los estudiantes.",section,581,112,9042,9623
info_cubo_rendimiento_v21.md,"## DIMENSION: Fecha de actualización ##

Notas generales:
- Indica la fecha de la última recarga de datos. Habitualmente es el domingo anterior a la consulta de datos.",section,168,34,9624,9792
info_cubo_rendimiento_v21.md,"## DIMENSION: Matrícula ##

Atributos:
• Grupo Asignatura:
Permite diferenciar los diferentes grupos de matrícula existentes en cada asignatura.

>Nota: se recomienda utilizar esta dimensión junto con la de Asignatura.

• Modalidad:
Permite diferenciar los datos en función de la dedicación que el estudiante tenga en la titulación en la que se matricula Esta condición se regula en el Reglamento de permanencia en títulos oficiales adaptados al EEES.

>Valores posibles: tiempo completo, tiempo parcial, otra dedicación (finalizando estudios, con menos del 15% de los
créditos del plan por superar).

>En titulaciones anteriores al EEES todos los estudiantes se matriculan a tiempo completo.
>Existe un número mínimo de créditos en que deberán matricularse los estudiantes, en función de cada modalidad.

• Número de veces:
Determina el número de veces que el alumno ha matriculado una misma asignatura en el curso académico que se seleccione (1 vez, 2 veces, 3 veces, 4 ó más veces).

>Nota: es una dimensión orientada a la asignatura, por lo que se recomienda no combinar esta variable con el plan de
estudios si queremos obtener el número de estudiantes matriculados, dado que éstos pueden matricular asignaturas con distinto número de veces en un mismo plan.",section,1264,235,9793,11057
info_cubo_rendimiento_v21.md,"## DIMENSION: Rendimiento ##

Atributos:
• Calificación:
Permite clasificar cada línea de matrícula en función de su calificación final.

>Valores posibles: matrícula de honor, sobresaliente, notable, aprobado, suspenso, no presentado, apto, no apt
anulada, incompatible, renuncia, suspenso-c, convalidada, renuncia, pendiente de calificar, etc.

• Convocatorias Consumidas:
Identifica el número de convocatorias a las que se ha presentado el alumno en una asignatura hasta el curso académic seleccionado.

• Rango de Nota Numérica:
Permite clasificar cada línea de matrícula en función de rangos de notas numéricas.

>Valores posibles: 0,0-4,9; 5,0-5,9; 6,0-6,9; 7,0-7,9; 8,0-8,9; 9,0-9,9; 10.

• Tipo de Reconocimiento:
Permite distinguir los créditos reconocidos según el tipo de reconocimiento.

>Valores posibles: reconocida, adaptada, convalidada.",section,854,156,11058,11912
info_cubo_rendimiento_v21.md,"## DIMENSION: Titulación ##

Atributos:
• Estudio:
Permite clasificar los datos en función del estudio cursado por los estudiantes. Observaciones:

>No es lo mismo “estudio” que “plan de estudios”.
>Bajo un mismo estudio pueden existir varios planes, bien porque se imparten en distintas localidades (ejemplos: ADE,
Enfermería, Magisterio, Medicina, etc.) o bien porque se ha renovado el plan de estudios, pero el estudio sigue siendo el mismo (ejemplos: másteres regulados por el RD 56/2005 que se renuevan en virtud del RD 1393/2007).

• Plan de Estudios:
Permite clasificar los datos en función del plan de estudios (código y denominación) cursado por los estudiantes.

• Rama de Conocimiento:
Permite clasificar los datos en función de la Rama de Conocimiento (Artes y Humanidades, Ciencias, Ciencias Sociales y Jurídicas, Ciencias de la Salud, Ingeniería y Arquitectura) a la que pertenece el estudio) cursado por los estudiantes.

• Tipo de Estudio:
Permite identificar el tipo de estudio cursado por los estudiantes: grado, máster, doctorado, movilidad de entrada. Con anterioridad al curso 2016/17 se muestran también licenciatura o equivalente, diplomatura o equivalente.",section,1182,226,11913,13095
info_cubo_rendimiento_v21.md,=== MEDIDAS ===,paragraph,15,3,0,15
info_cubo_rendimiento_v21.md,"** Tasa de Éxito **
Relación porcentual entre el número total de créditos superados por los estudiantes en un estudio y el número total d créditos presentados a examen. Observaciones:",paragraph,183,34,17,200
info_cubo_rendimiento_v21.md,">Se cuentan los créditos presentados una sola vez en el curso académico aunque se haya presentado a más de un
convocatoria en ese mismo curso.",paragraph,142,27,202,344
info_cubo_rendimiento_v21.md,">Se excluyen del cálculo los créditos de asignaturas cursadas por estudiantes de la UZ en otras universidades en virtu
de un programa de intercambio, los créditos de asignaturas del plan matriculados por estudiantes de programas d movilidad de otras universidades, los créditos matriculados en asignaturas que no son las del plan del alumno y l créditos reconocidos, adaptados o convalidados.",paragraph,392,65,346,738
info_cubo_rendimiento_v21.md,"** Tasa de Rendimiento **
Relación porcentual entre el número total de créditos superados por los estudiantes en un estudio y el número total d créditos matriculados (evaluados). Observaciones:",paragraph,193,35,740,933
info_cubo_rendimiento_v21.md,">Se consideran créditos matriculados aquellos que han sido evaluados, es decir, que han recibido calificación (presentad
o no presentado) en actas.",paragraph,147,27,935,1082
info_cubo_rendimiento_v21.md,">Se excluyen del cálculo los créditos de asignaturas cursadas por estudiantes de la UZ en otras universidades en virtu
de un programa de intercambio, los créditos de asignaturas del plan matriculados por estudiantes de programas d movilidad de otras universidades, los créditos matriculados en asignaturas que no son las del plan del alumno y l créditos reconocidos, adaptados o convalidados.",paragraph,392,65,1084,1476
info_cubo_rendimiento_v21.md,"** Tasa de Evaluación **
Relación porcentual entre el número total de créditos presentados a examen por los estudiantes en un estudio y número total de créditos matriculados (evaluados). Observaciones:",paragraph,201,36,1478,1679
info_cubo_rendimiento_v21.md,">Se cuentan los créditos presentados una sola vez en el curso académico aunque se haya presentado a más de un
convocatoria en ese mismo curso.",paragraph,142,27,1681,1823
info_cubo_rendimiento_v21.md,">Se consideran créditos matriculados aquellos que han sido evaluados, es decir, que han recibido calificación (presentad
o no presentado) en actas.",paragraph,147,27,1825,1972
info_cubo_rendimiento_v21.md,">Se excluyen del cálculo los créditos de asignaturas cursadas por estudiantes de la UZ en otras universidades en virtu
de un programa de intercambio, los créditos de asignaturas del plan matriculados por estudiantes de programas d movilidad de otras universidades, los créditos matriculados en asignaturas que no son las del plan del alumno y l créditos reconocidos, adaptados o convalidados.",paragraph,392,65,1974,2366
info_cubo_rendimiento_v21.md,"** Créditos Evaluados **
Incluye los créditos matriculados por los estudiantes que han sido calificados (los créditos que no han sido calificados n se contabilizan). Observaciones:",paragraph,180,32,2368,2548
info_cubo_rendimiento_v21.md,">Se tienen en cuenta los créditos que han recibido calificación (presentado o no presentado) en actas, lo cual deb
tenerse presente sobre todo en los cursos académicos abiertos.",paragraph,177,33,2550,2727
info_cubo_rendimiento_v21.md,>No se incluyen los créditos reconocidos.,paragraph,41,8,2729,2770
info_cubo_rendimiento_v21.md,"** Créditos Superados **
Créditos de asignaturas cuyos resultados de examen han obtenido cualquiera de las siguientes calificaciones: Aprobad Aprobado por compensación, Apto, Matrícula de Honor, Notable, Sobresaliente.",paragraph,218,36,2772,2990
info_cubo_rendimiento_v21.md,">Nota: no se incluyen los créditos adaptados, convalidados o reconocidos.",paragraph,73,14,2992,3065
info_cubo_rendimiento_v21.md,"** Créditos Presentados **
Suma de los créditos incluidos en las medidas ""créditos superados"" y ""créditos suspendidos"".",paragraph,119,24,3067,3186
info_cubo_rendimiento_v21.md,">Nota: se cuentan los créditos presentados una sola vez en el curso académico aunque el estudiante se haya presentad
a más de una convocatoria en ese mismo curso.",paragraph,162,31,3188,3350
info_cubo_rendimiento_v21.md,"** Créditos Suspendidos **
Créditos de asignaturas cuyos resultados de examen han obtenido cualquiera de las siguientes calificaciones: S=Suspens SC=Suspenso compensable.",paragraph,170,25,3352,3522
info_cubo_rendimiento_v21.md,">Nota: no se incluyen los créditos adaptados, convalidados o reconocidos.",paragraph,73,14,3524,3597
info_cubo_rendimiento_v21.md,"** Alumnos Evaluados **
Contabiliza el número de estudiantes que han recibido calificación en las asignaturas matriculadas. Observaciones:",paragraph,138,22,3599,3737
info_cubo_rendimiento_v21.md,">Se considera evaluado si han recibido calificación (presentado o no presentado) en actas. Debe tenerse presente que e
los cursos académicos abiertos puede haber créditos pendientes de calificar.",paragraph,195,33,3739,3934
info_cubo_rendimiento_v21.md,">Nota: las asignaturas adaptadas, convalidadas o reconocidas no contabilizan en este cálculo.",paragraph,93,16,3936,4029
info_cubo_rendimiento_v21.md,"** Alumnos Superados **
Contabiliza el número de estudiantes matriculados en asignaturas cuyos resultados en actas incluye cualquiera de l siguientes calificaciones: Aprobado, Aprobado por compensación, Apto, Matrícula de Honor, Notable, Sobresalient Evaluación Positiva.",paragraph,271,43,4031,4302
info_cubo_rendimiento_v21.md,">Nota: las asignaturas adaptadas, convalidadas o reconocidas no contabilizan en este cálculo.",paragraph,93,16,4304,4397
info_cubo_rendimiento_v21.md,"** Alumnos Presentados **
Contabiliza el número de estudiantes matriculados en asignaturas cuyos resultados en actas incluye cualquiera de l siguientes calificaciones: Aprobado, Aprobado por compensación, Apto, Matrícula de Honor, Notable, Sobresalient Evaluación Positiva, No Apto, Suspenso, Evaluación Negativa.",paragraph,313,51,4399,4712
info_cubo_rendimiento_v21.md,"** Créditos Reconocidos **
Créditos que, habiendo sido obtenidos con anterioridad en una enseñanza oficial de cualquier universidad, so computados en enseñanzas de la UZ a efectos de la obtención de un título oficial de Grado y de Máster. También se incluyen en este cómputo los créditos de asignaturas que han sido adaptadas y los créditos convalidados, decir, los que el alumno consigue para la titulación en la que está matriculado, por superación de conocimient académicos previos o realización de actividades que tienen reconocimiento académico. En el caso de crédit convalidados suspensos, se mantiene la calificación.",paragraph,624,107,4714,5338
info_cubo_rendimiento_v21.md,"** Nota Media de Admisión **
Es la media de las notas de admisión de los estudiantes evaluados en el curso académico seleccionado.",paragraph,130,26,5340,5470
info_cubo_rendimiento_v21.md,">Nota: los estudiantes que acceden al plan por un procedimiento distinto al de preinscripción y los que accedieron p
preinscripción con anterioridad al curso 2010/11 no tienen informada esta variable.",paragraph,200,33,5472,5672
info_cubo_rendimiento_v21.md,"** Media de Convocatorias Consumidas **
Es la media de las convocatorias que ha consumido un estudiante para una asignatura, una vez que la ha superado. S consigna en el curso académico en el que el estudiante supera la asignatura. Es, por tanto, un indicador del número d convocatorias que el estudiante consume hasta que supera la asignatura.",paragraph,344,66,5674,6018
info_cubo_rendimiento_v21.md,=== DIMENSIONES ===,paragraph,19,3,6020,6039
info_cubo_rendimiento_v21.md,## DIMENSION: Acceso ##,paragraph,23,7,6041,6064
info_cubo_rendimiento_v21.md,"Atributos:
• Estudio previo:
Identifica la clase de estudio cursado anteriormente por los estudiantes, que les da acceso a la Universidad, de acuerd con los requisitos establecidos por la legislación vigente.",paragraph,208,36,6066,6274
info_cubo_rendimiento_v21.md,">Valores posibles: Pruebas de Acceso, COU sin PAU, FP, Titulados Universitarios, Mayores de 25, Mayores de 40, Mayor
de 45.",paragraph,123,29,6276,6399
info_cubo_rendimiento_v21.md,">Los estudiantes procedentes de Bachillerato se incluyen en “Pruebas de Acceso”. Los estudiantes procedentes d
Ciclos Formativos de Grado Superior se incluyen en “FP”, aunque se hayan presentado a la fase específica de la EvAU",paragraph,226,42,6401,6627
info_cubo_rendimiento_v21.md,">Nota: el valor “No informado” se aplica a estudiantes procedentes de adaptaciones por extinción de planes de
estudios o que no han accedido a la titulación por procedimientos de preinscripción.",paragraph,194,35,6629,6823
info_cubo_rendimiento_v21.md,"• Nuevo Ingreso (S/N):
Indica si los estudiantes son de nuevo ingreso (S) o no (N) en el curso académico que se seleccione. Se considera que e estudiante es de nuevo ingreso si consume alguna de las plazas ofertadas para un año y plan (no se consideran matriculados de nuevo ingreso los que acceden a un estudio por el procedimiento de cambio de estudios, traslado de expediente, adaptación al grado, o los que anulan la matrícula).",paragraph,432,90,6825,7257
info_cubo_rendimiento_v21.md,"• Rango de Nota de Admisión:
Permite clasificar los estudiantes en función del rango de su nota de admisión. Observaciones:",paragraph,123,23,7259,7382
info_cubo_rendimiento_v21.md,">El valor “No informado” se aplica a estudiantes que acceden al plan por un procedimiento distinto al de preinscripció
y los que accedieron por preinscripción con anterioridad al curso 2010-11.",paragraph,193,34,7384,7577
info_cubo_rendimiento_v21.md,>Los rangos inferiores a 5 corresponden a las notas de admisión de estudiantes que acceden por el cupo de Titulados.,paragraph,116,22,7579,7695
info_cubo_rendimiento_v21.md,## DIMENSION: Alumno ##,paragraph,23,7,7697,7720
info_cubo_rendimiento_v21.md,"Atributos:
• País Nacionalidad:
Permite clasificar los datos en función del país de nacionalidad legal de los estudiantes.",paragraph,122,21,7722,7844
info_cubo_rendimiento_v21.md,"• Rango de Edad:
Permite agrupar los rangos de edad de los estudiantes en función de su edad a fecha 31 de diciembre del curso académico en que están matriculados.",paragraph,163,32,7846,8009
info_cubo_rendimiento_v21.md,">Valores posibles: 18 años o menos, 19, 20, 21, 22, 23, 24, 25, 26, 27, 28, 29, 30 a 34, 35 a 39, 40 a 44, 45 a 49, 50 a 54
55 a 59, 60 a 64, 65 años o más.",paragraph,156,63,8011,8167
info_cubo_rendimiento_v21.md,"• Residencia Familiar:
Identifica el país, la comunidad autónoma, la provincia o la población de residencia familiar indicada por el alumno en curso académico en que se matricula.",paragraph,179,32,8169,8348
info_cubo_rendimiento_v21.md,"• Sexo:
Permite agrupar los estudiantes en función de su sexo.",paragraph,62,13,8350,8412
info_cubo_rendimiento_v21.md,## DIMENSION: Asignatura ##,paragraph,27,7,8414,8441
info_cubo_rendimiento_v21.md,"Notas generales:
- Permite clasificar los datos en función de la asignatura (código y denominación) en que se matriculan los estudiantes.",paragraph,137,25,8443,8580
info_cubo_rendimiento_v21.md,"Atributos:
• Clase:
Permite clasificar los datos en función de la clase de asignatura (formación básica, obligatoria, optativa, libre elección, troncal, trabajo fin de grado, trabajo fin de máster, prácticas externas, complementos de formación, actividades académicas complementarias), tal como viene identificada en el plan de estudios.",paragraph,337,61,8582,8919
info_cubo_rendimiento_v21.md,## DIMENSION: CURSO ACADÉMICO ##,paragraph,32,8,8921,8953
info_cubo_rendimiento_v21.md,"Notas generales:
- Identifica los diferentes cursos académicos (por ejemplo 2023/24).",paragraph,85,15,8955,9040
info_cubo_rendimiento_v21.md,## DIMENSION: Centro ##,paragraph,23,7,9042,9065
info_cubo_rendimiento_v21.md,"Notas generales:
- Permite clasificar los datos en función del centro (código y denominación) de matrícula de los estudiantes.",paragraph,126,23,9067,9193
info_cubo_rendimiento_v21.md,"Atributos:
• Campus:
Permite clasificar los datos en función del campus en el que se ubica el centro de matrícula de los estudiantes.",paragraph,133,26,9195,9328
info_cubo_rendimiento_v21.md,"• Localidad:
Permite clasificar los datos en función de la localidad a la que pertenece el centro de matrícula de los estudiantes.",paragraph,130,24,9330,9460
info_cubo_rendimiento_v21.md,"• Tipo:
Permite clasificar los datos en función del tipo de centro (facultad, escuela universitaria, centro adscrito, etc.) en que s matriculan los estudiantes.",paragraph,160,32,9462,9622
info_cubo_rendimiento_v21.md,## DIMENSION: Fecha de actualización ##,paragraph,39,9,9624,9663
info_cubo_rendimiento_v21.md,"Notas generales:
- Indica la fecha de la última recarga de datos. Habitualmente es el domingo anterior a la consulta de datos.",paragraph,126,25,9665,9791
info_cubo_rendimiento_v21.md,## DIMENSION: Matrícula ##,paragraph,26,7,9793,9819
info_cubo_rendimiento_v21.md,"Atributos:
• Grupo Asignatura:
Permite diferenciar los diferentes grupos de matrícula existentes en cada asignatura.",paragraph,116,18,9821,9937
info_cubo_rendimiento_v21.md,>Nota: se recomienda utilizar esta dimensión junto con la de Asignatura.,paragraph,72,14,9939,10011
info_cubo_rendimiento_v21.md,"• Modalidad:
Permite diferenciar los datos en función de la dedicación que el estudiante tenga en la titulación en la que se matricula Esta condición se regula en el Reglamento de permanencia en títulos oficiales adaptados al EEES.",paragraph,231,40,10013,10244
info_cubo_rendimiento_v21.md,">Valores posibles: tiempo completo, tiempo parcial, otra dedicación (finalizando estudios, con menos del 15% de los
créditos del plan por superar).",paragraph,147,30,10246,10393
info_cubo_rendimiento_v21.md,">En titulaciones anteriores al EEES todos los estudiantes se matriculan a tiempo completo.
>Existe un número mínimo de créditos en que deberán matricularse los estudiantes, en función de cada modalidad.",paragraph,202,35,10395,10597
info_cubo_rendimiento_v21.md,"• Número de veces:
Determina el número de veces que el alumno ha matriculado una misma asignatura en el curso académico que se seleccione (1 vez, 2 veces, 3 veces, 4 ó más veces).",paragraph,179,41,10599,10778
info_cubo_rendimiento_v21.md,">Nota: es una dimensión orientada a la asignatura, por lo que se recomienda no combinar esta variable con el plan de
estudios si queremos obtener el número de estudiantes matriculados, dado que éstos pueden matricular asignaturas con distinto número de veces en un mismo plan.",paragraph,276,50,10780,11056
info_cubo_rendimiento_v21.md,## DIMENSION: Rendimiento ##,paragraph,28,7,11058,11086
info_cubo_rendimiento_v21.md,"Atributos:
• Calificación:
Permite clasificar cada línea de matrícula en función de su calificación final.",paragraph,106,18,11088,11194
info_cubo_rendimiento_v21.md,">Valores posibles: matrícula de honor, sobresaliente, notable, aprobado, suspenso, no presentado, apto, no apt
anulada, incompatible, renuncia, suspenso-c, convalidada, renuncia, pendiente de calificar, etc.",paragraph,207,41,11196,11403
info_cubo_rendimiento_v21.md,"• Convocatorias Consumidas:
Identifica el número de convocatorias a las que se ha presentado el alumno en una asignatura hasta el curso académic seleccionado.",paragraph,158,26,11405,11563
info_cubo_rendimiento_v21.md,"• Rango de Nota Numérica:
Permite clasificar cada línea de matrícula en función de rangos de notas numéricas.",paragraph,109,20,11565,11674
info_cubo_rendimiento_v21.md,">Valores posibles: 0,0-4,9; 5,0-5,9; 6,0-6,9; 7,0-7,9; 8,0-8,9; 9,0-9,9; 10.",paragraph,76,18,11676,11752
info_cubo_rendimiento_v21.md,"• Tipo de Reconocimiento:
Permite distinguir los créditos reconocidos según el tipo de reconocimiento.",paragraph,102,16,11754,11856
info_cubo_rendimiento_v21.md,">Valores posibles: reconocida, adaptada, convalidada.",paragraph,53,10,11858,11911
info_cubo_rendimiento_v21.md,## DIMENSION: Titulación ##,paragraph,27,7,11913,11940
info_cubo_rendimiento_v21.md,"Atributos:
• Estudio:
Permite clasificar los datos en función del estudio cursado por los estudiantes. Observaciones:",paragraph,117,20,11942,12059
info_cubo_rendimiento_v21.md,">No es lo mismo “estudio” que “plan de estudios”.
>Bajo un mismo estudio pueden existir varios planes, bien porque se imparten en distintas localidades (ejemplos: ADE,
Enfermería, Magisterio, Medicina, etc.) o bien porque se ha renovado el plan de estudios, pero el estudio sigue siendo el mismo (ejemplos: másteres regulados por el RD 56/2005 que se renuevan en virtud del RD 1393/2007).",paragraph,388,83,12061,12449
info_cubo_rendimiento_v21.md,"• Plan de Estudios:
Permite clasificar los datos en función del plan de estudios (código y denominación) cursado por los estudiantes.",paragraph,133,25,12451,12584
info_cubo_rendimiento_v21.md,"• Rama de Conocimiento:
Permite clasificar los datos en función de la Rama de Conocimiento (Artes y Humanidades, Ciencias, Ciencias Sociales y Jurídicas, Ciencias de la Salud, Ingeniería y Arquitectura) a la que pertenece el estudio) cursado por los estudiantes.",paragraph,262,49,12586,12848
info_cubo_rendimiento_v21.md,"• Tipo de Estudio:
Permite identificar el tipo de estudio cursado por los estudiantes: grado, máster, doctorado, movilidad de entrada. Con anterioridad al curso 2016/17 se muestran también licenciatura o equivalente, diplomatura o equivalente.",paragraph,243,42,12850,13093
info_cubo_rendimiento_v21.md,"=== MEDIDAS ===

** Tasa de Éxito **
Relación porcentual entre el número total de créditos superados por los estudiantes en un estudio y el número total d créditos presentados a examen.",sentence,185,35,0,185
info_cubo_rendimiento_v21.md,"Observaciones:

>Se cuentan los créditos presentados una sola vez en el curso académico aunque se haya presentado a más de un
convocatoria en ese mismo curso.",sentence,158,29,185,343
info_cubo_rendimiento_v21.md,">Se excluyen del cálculo los créditos de asignaturas cursadas por estudiantes de la UZ en otras universidades en virtu
de un programa de intercambio, los créditos de asignaturas del plan matriculados por estudiantes de programas d movilidad de otras universidades, los créditos matriculados en asignaturas que no son las del plan del alumno y l créditos reconocidos, adaptados o convalidados.",sentence,392,65,344,736
info_cubo_rendimiento_v21.md,"** Tasa de Rendimiento **
Relación porcentual entre el número total de créditos superados por los estudiantes en un estudio y el número total d créditos matriculados (evaluados).",sentence,178,33,738,916
info_cubo_rendimiento_v21.md,"Observaciones:

>Se consideran créditos matriculados aquellos que han sido evaluados, es decir, que han recibido calificación (presentad
o no presentado) en actas.",sentence,163,29,918,1081
info_cubo_rendimiento_v21.md,">Se excluyen del cálculo los créditos de asignaturas cursadas por estudiantes de la UZ en otras universidades en virtu
de un programa de intercambio, los créditos de asignaturas del plan matriculados por estudiantes de programas d movilidad de otras universidades, los créditos matriculados en asignaturas que no son las del plan del alumno y l créditos reconocidos, adaptados o convalidados.",sentence,392,65,1082,1474
info_cubo_rendimiento_v21.md,"** Tasa de Evaluación **
Relación porcentual entre el número total de créditos presentados a examen por los estudiantes en un estudio y número total de créditos matriculados (evaluados).",sentence,186,34,1476,1662
info_cubo_rendimiento_v21.md,"Observaciones:

>Se cuentan los créditos presentados una sola vez en el curso académico aunque se haya presentado a más de un
convocatoria en ese mismo curso.",sentence,158,29,1664,1822
info_cubo_rendimiento_v21.md,">Se consideran créditos matriculados aquellos que han sido evaluados, es decir, que han recibido calificación (presentad
o no presentado) en actas.",sentence,147,27,1823,1970
info_cubo_rendimiento_v21.md,">Se excluyen del cálculo los créditos de asignaturas cursadas por estudiantes de la UZ en otras universidades en virtu
de un programa de intercambio, los créditos de asignaturas del plan matriculados por estudiantes de programas d movilidad de otras universidades, los créditos matriculados en asignaturas que no son las del plan del alumno y l créditos reconocidos, adaptados o convalidados.",sentence,392,65,1972,2364
info_cubo_rendimiento_v21.md,"** Créditos Evaluados **
Incluye los créditos matriculados por los estudiantes que han sido calificados (los créditos que no han sido calificados n se contabilizan).",sentence,165,30,2366,2531
info_cubo_rendimiento_v21.md,"Observaciones:

>Se tienen en cuenta los créditos que han recibido calificación (presentado o no presentado) en actas, lo cual deb
tenerse presente sobre todo en los cursos académicos abiertos.",sentence,193,35,2533,2726
info_cubo_rendimiento_v21.md,>No se incluyen los créditos reconocidos.,sentence,41,8,2727,2768
info_cubo_rendimiento_v21.md,"** Créditos Superados **
Créditos de asignaturas cuyos resultados de examen han obtenido cualquiera de las siguientes calificaciones: Aprobad Aprobado por compensación, Apto, Matrícula de Honor, Notable, Sobresaliente.",sentence,218,36,2770,2988
info_cubo_rendimiento_v21.md,">Nota: no se incluyen los créditos adaptados, convalidados o reconocidos.",sentence,73,14,2990,3063
info_cubo_rendimiento_v21.md,"** Créditos Presentados **
Suma de los créditos incluidos en las medidas ""créditos superados"" y ""créditos suspendidos"".",sentence,119,24,3065,3184
info_cubo_rendimiento_v21.md,">Nota: se cuentan los créditos presentados una sola vez en el curso académico aunque el estudiante se haya presentad
a más de una convocatoria en ese mismo curso.",sentence,162,31,3186,3348
info_cubo_rendimiento_v21.md,"** Créditos Suspendidos **
Créditos de asignaturas cuyos resultados de examen han obtenido cualquiera de las siguientes calificaciones: S=Suspens SC=Suspenso compensable.",sentence,170,25,3350,3520
info_cubo_rendimiento_v21.md,">Nota: no se incluyen los créditos adaptados, convalidados o reconocidos.",sentence,73,14,3522,3595
info_cubo_rendimiento_v21.md,"** Alumnos Evaluados **
Contabiliza el número de estudiantes que han recibido calificación en las asignaturas matriculadas.",sentence,123,20,3597,3720
info_cubo_rendimiento_v21.md,"Observaciones:

>Se considera evaluado si han recibido calificación (presentado o no presentado) en actas.",sentence,106,19,3722,3828
info_cubo_rendimiento_v21.md,"Debe tenerse presente que e
los cursos académicos abiertos puede haber créditos pendientes de calificar.",sentence,104,16,3829,3933
info_cubo_rendimiento_v21.md,">Nota: las asignaturas adaptadas, convalidadas o reconocidas no contabilizan en este cálculo.",sentence,93,16,3934,4027
info_cubo_rendimiento_v21.md,"** Alumnos Superados **
Contabiliza el número de estudiantes matriculados en asignaturas cuyos resultados en actas incluye cualquiera de l siguientes calificaciones: Aprobado, Aprobado por compensación, Apto, Matrícula de Honor, Notable, Sobresalient Evaluación Positiva.",sentence,271,43,4029,4300
info_cubo_rendimiento_v21.md,">Nota: las asignaturas adaptadas, convalidadas o reconocidas no contabilizan en este cálculo.",sentence,93,16,4302,4395
info_cubo_rendimiento_v21.md,"** Alumnos Presentados **
Contabiliza el número de estudiantes matriculados en asignaturas cuyos resultados en actas incluye cualquiera de l siguientes calificaciones: Aprobado, Aprobado por compensación, Apto, Matrícula de Honor, Notable, Sobresalient Evaluación Positiva, No Apto, Suspenso, Evaluación Negativa.",sentence,313,51,4397,4710
info_cubo_rendimiento_v21.md,"** Créditos Reconocidos **
Créditos que, habiendo sido obtenidos con anterioridad en una enseñanza oficial de cualquier universidad, so computados en enseñanzas de la UZ a efectos de la obtención de un título oficial de Grado y de Máster.",sentence,238,44,4712,4950
info_cubo_rendimiento_v21.md,"También se incluyen en este cómputo los créditos de asignaturas que han sido adaptadas y los créditos convalidados, decir, los que el alumno consigue para la titulación en la que está matriculado, por superación de conocimient académicos previos o realización de actividades que tienen reconocimiento académico.",sentence,311,50,4952,5263
info_cubo_rendimiento_v21.md,"En el caso de crédit convalidados suspensos, se mantiene la calificación.",sentence,73,13,5264,5337
info_cubo_rendimiento_v21.md,"** Nota Media de Admisión **
Es la media de las notas de admisión de los estudiantes evaluados en el curso académico seleccionado.",sentence,130,26,5338,5468
info_cubo_rendimiento_v21.md,">Nota: los estudiantes que acceden al plan por un procedimiento distinto al de preinscripción y los que accedieron p
preinscripción con anterioridad al curso 2010/11 no tienen informada esta variable.",sentence,200,33,5470,5670
info_cubo_rendimiento_v21.md,"** Media de Convocatorias Consumidas **
Es la media de las convocatorias que ha consumido un estudiante para una asignatura, una vez que la ha superado.",sentence,152,30,5672,5824
info_cubo_rendimiento_v21.md,S consigna en el curso académico en el que el estudiante supera la asignatura.,sentence,78,15,5826,5904
info_cubo_rendimiento_v21.md,"Es, por tanto, un indicador del número d convocatorias que el estudiante consume hasta que supera la asignatura.",sentence,112,21,5905,6017
info_cubo_rendimiento_v21.md,"=== DIMENSIONES ===

## DIMENSION: Acceso ##

Atributos:
• Estudio previo:
Identifica la clase de estudio cursado anteriormente por los estudiantes, que les da acceso a la Universidad, de acuerd con los requisitos establecidos por la legislación vigente.",sentence,254,46,6018,6272
info_cubo_rendimiento_v21.md,">Valores posibles: Pruebas de Acceso, COU sin PAU, FP, Titulados Universitarios, Mayores de 25, Mayores de 40, Mayor
de 45.",sentence,123,29,6274,6397
info_cubo_rendimiento_v21.md,>Los estudiantes procedentes de Bachillerato se incluyen en “Pruebas de Acceso”.,sentence,80,15,6399,6479
info_cubo_rendimiento_v21.md,"Los estudiantes procedentes d
Ciclos Formativos de Grado Superior se incluyen en “FP”, aunque se hayan presentado a la fase específica de la EvAU

>Nota: el valor “No informado” se aplica a estudiantes procedentes de adaptaciones por extinción de planes de
estudios o que no han accedido a la titulación por procedimientos de preinscripción.",sentence,341,62,6481,6822
info_cubo_rendimiento_v21.md,"• Nuevo Ingreso (S/N):
Indica si los estudiantes son de nuevo ingreso (S) o no (N) en el curso académico que se seleccione.",sentence,123,31,6823,6946
info_cubo_rendimiento_v21.md,"Se considera que e estudiante es de nuevo ingreso si consume alguna de las plazas ofertadas para un año y plan (no se consideran matriculados de nuevo ingreso los que acceden a un estudio por el procedimiento de cambio de estudios, traslado de expediente, adaptación al grado, o los que anulan la matrícula).",sentence,308,59,6948,7256
info_cubo_rendimiento_v21.md,"• Rango de Nota de Admisión:
Permite clasificar los estudiantes en función del rango de su nota de admisión.",sentence,108,21,7257,7365
info_cubo_rendimiento_v21.md,"Observaciones:

>El valor “No informado” se aplica a estudiantes que acceden al plan por un procedimiento distinto al de preinscripció
y los que accedieron por preinscripción con anterioridad al curso 2010-11.",sentence,209,36,7367,7576
info_cubo_rendimiento_v21.md,>Los rangos inferiores a 5 corresponden a las notas de admisión de estudiantes que acceden por el cupo de Titulados.,sentence,116,22,7577,7693
info_cubo_rendimiento_v21.md,"## DIMENSION: Alumno ##

Atributos:
• País Nacionalidad:
Permite clasificar los datos en función del país de nacionalidad legal de los estudiantes.",sentence,147,28,7695,7842
info_cubo_rendimiento_v21.md,"• Rango de Edad:
Permite agrupar los rangos de edad de los estudiantes en función de su edad a fecha 31 de diciembre del curso académico en que están matriculados.",sentence,163,32,7844,8007
info_cubo_rendimiento_v21.md,">Valores posibles: 18 años o menos, 19, 20, 21, 22, 23, 24, 25, 26, 27, 28, 29, 30 a 34, 35 a 39, 40 a 44, 45 a 49, 50 a 54
55 a 59, 60 a 64, 65 años o más.",sentence,156,63,8009,8165
info_cubo_rendimiento_v21.md,"• Residencia Familiar:
Identifica el país, la comunidad autónoma, la provincia o la población de residencia familiar indicada por el alumno en curso académico en que se matricula.",sentence,179,32,8167,8346
info_cubo_rendimiento_v21.md,"• Sexo:
Permite agrupar los estudiantes en función de su sexo.",sentence,62,13,8348,8410
info_cubo_rendimiento_v21.md,"## DIMENSION: Asignatura ##

Notas generales:
- Permite clasificar los datos en función de la asignatura (código y denominación) en que se matriculan los estudiantes.",sentence,166,32,8412,8578
info_cubo_rendimiento_v21.md,"Atributos:
• Clase:
Permite clasificar los datos en función de la clase de asignatura (formación básica, obligatoria, optativa, libre elección, troncal, trabajo fin de grado, trabajo fin de máster, prácticas externas, complementos de formación, actividades académicas complementarias), tal como viene identificada en el plan de estudios.",sentence,337,61,8580,8917
info_cubo_rendimiento_v21.md,"## DIMENSION: CURSO ACADÉMICO ##

Notas generales:
- Identifica los diferentes cursos académicos (por ejemplo 2023/24).",sentence,119,23,8919,9038
info_cubo_rendimiento_v21.md,"## DIMENSION: Centro ##

Notas generales:
- Permite clasificar los datos en función del centro (código y denominación) de matrícula de los estudiantes.",sentence,151,30,9040,9191
info_cubo_rendimiento_v21.md,"Atributos:
• Campus:
Permite clasificar los datos en función del campus en el que se ubica el centro de matrícula de los estudiantes.",sentence,133,26,9193,9326
info_cubo_rendimiento_v21.md,"• Localidad:
Permite clasificar los datos en función de la localidad a la que pertenece el centro de matrícula de los estudiantes.",sentence,130,24,9328,9458
info_cubo_rendimiento_v21.md,"• Tipo:
Permite clasificar los datos en función del tipo de centro (facultad, escuela universitaria, centro adscrito, etc.)",sentence,123,25,9460,9583
info_cubo_rendimiento_v21.md,en que s matriculan los estudiantes.,sentence,36,7,9585,9621
info_cubo_rendimiento_v21.md,"## DIMENSION: Fecha de actualización ##

Notas generales:
- Indica la fecha de la última recarga de datos.",sentence,106,23,9622,9728
info_cubo_rendimiento_v21.md,Habitualmente es el domingo anterior a la consulta de datos.,sentence,60,11,9730,9790
info_cubo_rendimiento_v21.md,"## DIMENSION: Matrícula ##

Atributos:
• Grupo Asignatura:
Permite diferenciar los diferentes grupos de matrícula existentes en cada asignatura.",sentence,144,25,9791,9935
info_cubo_rendimiento_v21.md,>Nota: se recomienda utilizar esta dimensión junto con la de Asignatura.,sentence,72,14,9937,10009
info_cubo_rendimiento_v21.md,"• Modalidad:
Permite diferenciar los datos en función de la dedicación que el estudiante tenga en la titulación en la que se matricula Esta condición se regula en el Reglamento de permanencia en títulos oficiales adaptados al EEES.",sentence,231,40,10011,10242
info_cubo_rendimiento_v21.md,">Valores posibles: tiempo completo, tiempo parcial, otra dedicación (finalizando estudios, con menos del 15% de los
créditos del plan por superar).",sentence,147,30,10244,10391
info_cubo_rendimiento_v21.md,>En titulaciones anteriores al EEES todos los estudiantes se matriculan a tiempo completo.,sentence,90,15,10393,10483
info_cubo_rendimiento_v21.md,">Existe un número mínimo de créditos en que deberán matricularse los estudiantes, en función de cada modalidad.",sentence,111,20,10485,10596
info_cubo_rendimiento_v21.md,"• Número de veces:
Determina el número de veces que el alumno ha matriculado una misma asignatura en el curso académico que se seleccione (1 vez, 2 veces, 3 veces, 4 ó más veces).",sentence,179,41,10597,10776
info_cubo_rendimiento_v21.md,">Nota: es una dimensión orientada a la asignatura, por lo que se recomienda no combinar esta variable con el plan de
estudios si queremos obtener el número de estudiantes matriculados, dado que éstos pueden matricular asignaturas con distinto número de veces en un mismo plan.",sentence,276,50,10778,11054
info_cubo_rendimiento_v21.md,"## DIMENSION: Rendimiento ##

Atributos:
• Calificación:
Permite clasificar cada línea de matrícula en función de su calificación final.",sentence,136,25,11056,11192
info_cubo_rendimiento_v21.md,">Valores posibles: matrícula de honor, sobresaliente, notable, aprobado, suspenso, no presentado, apto, no apt
anulada, incompatible, renuncia, suspenso-c, convalidada, renuncia, pendiente de calificar, etc.",sentence,207,41,11194,11401
info_cubo_rendimiento_v21.md,"• Convocatorias Consumidas:
Identifica el número de convocatorias a las que se ha presentado el alumno en una asignatura hasta el curso académic seleccionado.",sentence,158,26,11403,11561
info_cubo_rendimiento_v21.md,"• Rango de Nota Numérica:
Permite clasificar cada línea de matrícula en función de rangos de notas numéricas.",sentence,109,20,11563,11672
info_cubo_rendimiento_v21.md,">Valores posibles: 0,0-4,9; 5,0-5,9; 6,0-6,9; 7,0-7,9; 8,0-8,9; 9,0-9,9; 10.",sentence,76,18,11674,11750
info_cubo_rendimiento_v21.md,"• Tipo de Reconocimiento:
Permite distinguir los créditos reconocidos según el tipo de reconocimiento.",sentence,102,16,11752,11854
info_cubo_rendimiento_v21.md,">Valores posibles: reconocida, adaptada, convalidada.",sentence,53,10,11856,11909
info_cubo_rendimiento_v21.md,"## DIMENSION: Titulación ##

Atributos:
• Estudio:
Permite clasificar los datos en función del estudio cursado por los estudiantes.",sentence,131,25,11911,12042
info_cubo_rendimiento_v21.md,"Observaciones:

>No es lo mismo “estudio” que “plan de estudios”.",sentence,65,17,12044,12109
info_cubo_rendimiento_v21.md,">Bajo un mismo estudio pueden existir varios planes, bien porque se imparten en distintas localidades (ejemplos: ADE,
Enfermería, Magisterio, Medicina, etc.)",sentence,157,31,12110,12267
info_cubo_rendimiento_v21.md,"o bien porque se ha renovado el plan de estudios, pero el estudio sigue siendo el mismo (ejemplos: másteres regulados por el RD 56/2005 que se renuevan en virtud del RD 1393/2007).",sentence,180,37,12268,12448
info_cubo_rendimiento_v21.md,"• Plan de Estudios:
Permite clasificar los datos en función del plan de estudios (código y denominación) cursado por los estudiantes.",sentence,133,25,12449,12582
info_cubo_rendimiento_v21.md,"• Rama de Conocimiento:
Permite clasificar los datos en función de la Rama de Conocimiento (Artes y Humanidades, Ciencias, Ciencias Sociales y Jurídicas, Ciencias de la Salud, Ingeniería y Arquitectura) a la que pertenece el estudio) cursado por los estudiantes.",sentence,262,49,12584,12846
info_cubo_rendimiento_v21.md,"• Tipo de Estudio:
Permite identificar el tipo de estudio cursado por los estudiantes: grado, máster, doctorado, movilidad de entrada.",sentence,134,26,12848,12982
info_cubo_rendimiento_v21.md,"Con anterioridad al curso 2016/17 se muestran también licenciatura o equivalente, diplomatura o equivalente.",sentence,108,16,12984,13092
info_cubo_RRHHidi_v13.md,"=== MEDIDAS ===

** Número de investigadores **
Número de investigadores en la Universidad de Zaragoza, entendiendo como tales: • todos los que participen en un proyecto de investigación • todos los que pertenezcan a un grupo de investigación • todos los que pertenezcan a instituto de investigación (ya sea un Instituto Universitario de Investigació otras estructuras de investigación, como el Instituto de Investigación Sanitaria de Aragón) • efectivos de PDI cuyos puestos estén asignados a un programa presupuestario de investigación o que tengan asignada como categoría del puesto alguna de las siguientes denominaciones: investigador, investigador en formación, investigador novel, doctor colaborador senior, doctor colaborador junior, investigador iniciado-experiencia, investigador iniciado, investigador predoctoral en formación. • efectivos de PAS cuyos puestos estén asignados a un programa presupuestario de investigación o que tengan asignada como categoría del puesto la denominación “Titulado Superior-Proyectos de Investigación”. • el personal de movilidad de entrada • el personal en formación (ayudas FPU, ayudas PIF, ayudas predoctorales, etc.)

>Nota: Se recomienda incorporar a la consulta la dimensión 'tiempo' para que se muestren los datos por añ
fecha concreta. De lo contrario se acumularán todos los investigadores desde que existen datos.",section,1367,223,0,1367
info_cubo_RRHHidi_v13.md,=== DIMENSIONES ===,section,20,3,1368,1388
info_cubo_RRHHidi_v13.md,"## DIMENSION: Categoría Cuerpo Escala ##

Notas generales:
- Permite clasificar los datos en función de la categoría/cuerpo/escala a la que pertenecen los empleados.",section,166,29,1389,1555
info_cubo_RRHHidi_v13.md,"## DIMENSION: Categoría Investigador ##

Notas generales:
- Permite clasificar a los investigadores en función de la categoría que figura en su contrato de investigador.",section,170,30,1556,1726
info_cubo_RRHHidi_v13.md,"## DIMENSION: Centro ##

Notas generales:
- Permite clasificar los datos en función del centro al que pertenecen los investigadores.",section,133,25,1727,1860
info_cubo_RRHHidi_v13.md,"## DIMENSION: Departamento ##

Notas generales:
- Permite clasificar los datos en función del departamento al que están adscritos los investigadores.",section,150,26,1861,2011
info_cubo_RRHHidi_v13.md,"## DIMENSION: Doctor (S/N) ##

Notas generales:
- Permite clasificar a los investigadores en función de si figuran como Doctor en las bases de datos de persona (S) o no (N).",section,174,42,2012,2186
info_cubo_RRHHidi_v13.md,"## DIMENSION: Edad ##

Notas generales:
- Permite agrupar los rangos de edad de los investigadores en función de su fecha de nacimiento.

>Valores posibles: 20 años o menos, 21 a 30, 31 a 40, 41 a 50, 51 a 60, 60 años o más.",section,225,58,2187,2412
info_cubo_RRHHidi_v13.md,"## DIMENSION: Fecha de actualización ##

Notas generales:
- Indica la fecha de la última recarga de datos. Habitualmente es el domingo anterior a la consulta de datos.",section,168,34,2413,2581
info_cubo_RRHHidi_v13.md,"## DIMENSION: Grupo de investigación ##

Notas generales:
- Permite clasificar los datos en función del grupo de investigación al que, en su caso, pertenecen los investigadores. Si no pertenecen a ningún grupo de investigación, figura “No informado”.",section,251,49,2582,2833
info_cubo_RRHHidi_v13.md,"## DIMENSION: Grupo gestionado UZ (S/N) ##

Notas generales:
- Permite clasificar los datos en función de si el grupo de investigación es gestionado desde la UZ (S) o es exte a la misma (N).",section,191,46,2834,3025
info_cubo_RRHHidi_v13.md,"## DIMENSION: Instituto de investigación ##

Notas generales:
- Permite clasificar los datos en función del instituto universitario de investigación (IUI) al que pertenecen los investigadores. Si no pertenecen a ningún IUI, figura “No informado”.",section,247,46,3026,3273
info_cubo_RRHHidi_v13.md,"## DIMENSION: Investigador ##

Atributos:
• Modalidad de personal:
Permite clasificar los investigadores en función de la modalidad de nombramiento o tipo de contrato.

>Valores posibles: de carrera, interino, indefinido fijo, indefinido no fijo, temporal, convencional (es el caso
los colaboradores extraordinarios y el de los eméritos).

>Se recomienda incorporar en la consulta la dimensión “PAS o PDI” para poder distinguir entre las diferente
modalidades.

• Tesis dirigidas:
Permite clasificar los investigadores en función del número de tesis doctorales correspondientes a programa de doctorado regulados por el RD 99/2011 dirigidas o codirigidas en la fecha de consulta.

>Importante: en el caso de que una tesis doctoral haya sido dirigida por ‘n’ codirectores, se les adjudica a ca
uno de ellos el número de tesis ‘1/n’.

• Tesis dirigidas con mención internacional:
Permite clasificar los investigadores en función del número de tesis doctorales con mención internacional correspondientes a programas de doctorado regulados por el RD 99/2011 dirigidas o codirigidas en la fecha consulta.

>Importante: en el caso de que una tesis doctoral haya sido dirigida por ‘n’ codirectores, se les adjudica a ca
uno de ellos el número de tesis ‘1/n’.

• Tipo de miembro en el grupo de investigación:
Permite agrupar a los investigadores en función de su relación con el grupo de investigación al que, en su ca pertenecen.

>Valores posibles: investigador principal, colaborador, becario o externo a la UZ.",section,1506,279,3274,4780
info_cubo_RRHHidi_v13.md,"## DIMENSION: Macroárea ##

Notas generales:
- Permite clasificar los datos en función de la macroárea a la que pertenecen los investigadores.

>Valores posibles: Artes y Humanidades, Ciencias, Ciencias Sociales y Jurídicas, Ciencias de la Salud, Ingenier
Arquitectura.",section,270,50,4781,5051
info_cubo_RRHHidi_v13.md,"## DIMENSION: Nivel formativo ##

Notas generales:
- Permite clasificar los datos en función del nivel formativo de los investigadores.

>Valores posibles: bachiller elemental o equivalente, bachiller superior o equivalente, diplomados o
equivalente, licenciados o equivalente, Máster (EEES), Doctor.",section,301,54,5052,5353
info_cubo_RRHHidi_v13.md,"## DIMENSION: Otros Centros de Investigación ##

Notas generales:
- Permite clasificar los datos en función de si los investigadores pertenecen o no a estructuras de investigació distintas a los institutos universitarios de investigación (por ejemplo: IIS - Instituto de Investigación Sanitaria Aragón).",section,304,51,5354,5658
info_cubo_RRHHidi_v13.md,"## DIMENSION: PAS o PDI ##

Notas generales:
- Permite clasificar a los investigadores en función de si figuran como PAS o PDI o BECARIOS en las bases de datos de personal. El valor ""no informado"" agrupa a los investigadores que no figuran en PeopleSoft.",section,255,53,5659,5914
info_cubo_RRHHidi_v13.md,"## DIMENSION: Participa Proyecto (S/N) ##

Notas generales:
- Permite clasificar a los investigadores en función de si figuran como participantes en un proyecto de I+D+i (S no (N).",section,181,39,5915,6096
info_cubo_RRHHidi_v13.md,"## DIMENSION: País Nacionalidad ##

Notas generales:
- Permite clasificar los datos en función del país de nacionalidad legal de los investigadores.",section,149,27,6097,6246
info_cubo_RRHHidi_v13.md,"## DIMENSION: Programa presupuestario ##

Notas generales:
- Permite clasificar los datos en función del programa presupuestario al que está asignado el puesto del investigador.",section,178,30,6247,6425
info_cubo_RRHHidi_v13.md,"## DIMENSION: Puesto de Investigación (S/N) ##

Notas generales:
- Permite distinguir si los investigadores ocupan un puesto de investigación (S) o no (N). Se considera que ocu un puesto de investigación si pertenecen a alguna categoría de investigador o si ocupan puestos asignados a programas presupuestarios de investigación (541-I, 148I, 171I, 417-I, 423-I, 425-I ó 450-I).",section,378,76,6426,6804
info_cubo_RRHHidi_v13.md,"## DIMENSION: Sexo del investigador ##

Notas generales:
- Permite agrupar a los investigadores en función de su sexo.",section,119,24,6805,6924
info_cubo_RRHHidi_v13.md,"## DIMENSION: TIEMPO ##

Notas generales:
- Permite ubicar en el tiempo la relación de los investigadores con la UZ. Se pueden desglosar los datos según año o el mes: • MES: se incluyen los investigadores existentes a fecha último día del mes seleccionado (si se trata de u mes en curso, se incluyen los investigadores existentes a la fecha de la última carga). • AÑO: se acumulan los investigadores existentes a fecha último día de todos los meses del año seleccionado (si el año seleccionado es un año en curso, se acumulan los efectivos existentes a fecha último día de los meses anteriores y para el mes en curso los efectivos existentes a la fecha de la últim carga).",section,673,136,6925,7598
info_cubo_RRHHidi_v13.md,"## DIMENSION: Tipo de Grupo de Investigación ##

Notas generales:
- Permite agrupar a los investigadores en función de la tipología del grupo de investigación al que, en su caso, pertenecen.

>Valores posibles: Emergente, Consolidado, Consolidado de Investigación Aplicada, Excelente.",section,285,53,7599,7884
info_cubo_RRHHidi_v13.md,"## DIMENSION: Tramos ##

Atributos:
• Investigación Sexenios Estatales:
Permite clasificar los datos en función del número de sexenios o tramos de investigación reconocidos por la CNEAI a los investigadores. Se incluyen tanto los reconocidos a los cuerpos de funcionarios docentes universitarios como al personal contratado.

• Investigación Sexenios posibles:
Permite clasificar los funcionarios doctores en función del número de sexenios posibles.

>Fórmula de cálculo: [año que se selecciona – (año de obtención del título de Doctor + 1)]/6 (redondeando
entero inferior)

>En aquellos casos que no está informada la fecha de obtención del título de Doctor, se establece añadiend
la fecha de nacimiento 32,97 años (es, a fecha noviembre de 2013, la media de edad de obtención del título Doctor en la UZ de los empleados que sí tienen informada la fecha de obtención del título de Doctor).

>Al poderse solicitar sexenios con carácter retrospectivo (méritos de investigación realizados en fechas
anteriores a la obtención del título de doctor) existe la posibilidad de que el número de sexenios posibles se inferior al número de sexenios conseguidos.",section,1153,206,7885,9038
info_cubo_RRHHidi_v13.md,=== MEDIDAS ===,paragraph,15,3,0,15
info_cubo_RRHHidi_v13.md,"** Número de investigadores **
Número de investigadores en la Universidad de Zaragoza, entendiendo como tales: • todos los que participen en un proyecto de investigación • todos los que pertenezcan a un grupo de investigación • todos los que pertenezcan a instituto de investigación (ya sea un Instituto Universitario de Investigació otras estructuras de investigación, como el Instituto de Investigación Sanitaria de Aragón) • efectivos de PDI cuyos puestos estén asignados a un programa presupuestario de investigación o que tengan asignada como categoría del puesto alguna de las siguientes denominaciones: investigador, investigador en formación, investigador novel, doctor colaborador senior, doctor colaborador junior, investigador iniciado-experiencia, investigador iniciado, investigador predoctoral en formación. • efectivos de PAS cuyos puestos estén asignados a un programa presupuestario de investigación o que tengan asignada como categoría del puesto la denominación “Titulado Superior-Proyectos de Investigación”. • el personal de movilidad de entrada • el personal en formación (ayudas FPU, ayudas PIF, ayudas predoctorales, etc.)",paragraph,1146,183,17,1163
info_cubo_RRHHidi_v13.md,">Nota: Se recomienda incorporar a la consulta la dimensión 'tiempo' para que se muestren los datos por añ
fecha concreta. De lo contrario se acumularán todos los investigadores desde que existen datos.",paragraph,201,37,1165,1366
info_cubo_RRHHidi_v13.md,=== DIMENSIONES ===,paragraph,19,3,1368,1387
info_cubo_RRHHidi_v13.md,## DIMENSION: Categoría Cuerpo Escala ##,paragraph,40,9,1389,1429
info_cubo_RRHHidi_v13.md,"Notas generales:
- Permite clasificar los datos en función de la categoría/cuerpo/escala a la que pertenecen los empleados.",paragraph,123,20,1431,1554
info_cubo_RRHHidi_v13.md,## DIMENSION: Categoría Investigador ##,paragraph,39,8,1556,1595
info_cubo_RRHHidi_v13.md,"Notas generales:
- Permite clasificar a los investigadores en función de la categoría que figura en su contrato de investigador.",paragraph,128,22,1597,1725
info_cubo_RRHHidi_v13.md,## DIMENSION: Centro ##,paragraph,23,7,1727,1750
info_cubo_RRHHidi_v13.md,"Notas generales:
- Permite clasificar los datos en función del centro al que pertenecen los investigadores.",paragraph,107,18,1752,1859
info_cubo_RRHHidi_v13.md,## DIMENSION: Departamento ##,paragraph,29,7,1861,1890
info_cubo_RRHHidi_v13.md,"Notas generales:
- Permite clasificar los datos en función del departamento al que están adscritos los investigadores.",paragraph,118,19,1892,2010
info_cubo_RRHHidi_v13.md,## DIMENSION: Doctor (S/N) ##,paragraph,29,10,2012,2041
info_cubo_RRHHidi_v13.md,"Notas generales:
- Permite clasificar a los investigadores en función de si figuran como Doctor en las bases de datos de persona (S) o no (N).",paragraph,142,32,2043,2185
info_cubo_RRHHidi_v13.md,## DIMENSION: Edad ##,paragraph,21,7,2187,2208
info_cubo_RRHHidi_v13.md,"Notas generales:
- Permite agrupar los rangos de edad de los investigadores en función de su fecha de nacimiento.",paragraph,113,21,2210,2323
info_cubo_RRHHidi_v13.md,">Valores posibles: 20 años o menos, 21 a 30, 31 a 40, 41 a 50, 51 a 60, 60 años o más.",paragraph,86,30,2325,2411
info_cubo_RRHHidi_v13.md,## DIMENSION: Fecha de actualización ##,paragraph,39,9,2413,2452
info_cubo_RRHHidi_v13.md,"Notas generales:
- Indica la fecha de la última recarga de datos. Habitualmente es el domingo anterior a la consulta de datos.",paragraph,126,25,2454,2580
info_cubo_RRHHidi_v13.md,## DIMENSION: Grupo de investigación ##,paragraph,39,9,2582,2621
info_cubo_RRHHidi_v13.md,"Notas generales:
- Permite clasificar los datos en función del grupo de investigación al que, en su caso, pertenecen los investigadores. Si no pertenecen a ningún grupo de investigación, figura “No informado”.",paragraph,209,40,2623,2832
info_cubo_RRHHidi_v13.md,## DIMENSION: Grupo gestionado UZ (S/N) ##,paragraph,42,12,2834,2876
info_cubo_RRHHidi_v13.md,"Notas generales:
- Permite clasificar los datos en función de si el grupo de investigación es gestionado desde la UZ (S) o es exte a la misma (N).",paragraph,146,34,2878,3024
info_cubo_RRHHidi_v13.md,## DIMENSION: Instituto de investigación ##,paragraph,43,9,3026,3069
info_cubo_RRHHidi_v13.md,"Notas generales:
- Permite clasificar los datos en función del instituto universitario de investigación (IUI) al que pertenecen los investigadores. Si no pertenecen a ningún IUI, figura “No informado”.",paragraph,201,37,3071,3272
info_cubo_RRHHidi_v13.md,## DIMENSION: Investigador ##,paragraph,29,7,3274,3303
info_cubo_RRHHidi_v13.md,"Atributos:
• Modalidad de personal:
Permite clasificar los investigadores en función de la modalidad de nombramiento o tipo de contrato.",paragraph,136,23,3305,3441
info_cubo_RRHHidi_v13.md,">Valores posibles: de carrera, interino, indefinido fijo, indefinido no fijo, temporal, convencional (es el caso
los colaboradores extraordinarios y el de los eméritos).",paragraph,169,33,3443,3612
info_cubo_RRHHidi_v13.md,">Se recomienda incorporar en la consulta la dimensión “PAS o PDI” para poder distinguir entre las diferente
modalidades.",paragraph,120,22,3614,3734
info_cubo_RRHHidi_v13.md,"• Tesis dirigidas:
Permite clasificar los investigadores en función del número de tesis doctorales correspondientes a programa de doctorado regulados por el RD 99/2011 dirigidas o codirigidas en la fecha de consulta.",paragraph,216,34,3736,3952
info_cubo_RRHHidi_v13.md,">Importante: en el caso de que una tesis doctoral haya sido dirigida por ‘n’ codirectores, se les adjudica a ca
uno de ellos el número de tesis ‘1/n’.",paragraph,150,36,3954,4104
info_cubo_RRHHidi_v13.md,"• Tesis dirigidas con mención internacional:
Permite clasificar los investigadores en función del número de tesis doctorales con mención internacional correspondientes a programas de doctorado regulados por el RD 99/2011 dirigidas o codirigidas en la fecha consulta.",paragraph,266,39,4106,4372
info_cubo_RRHHidi_v13.md,">Importante: en el caso de que una tesis doctoral haya sido dirigida por ‘n’ codirectores, se les adjudica a ca
uno de ellos el número de tesis ‘1/n’.",paragraph,150,36,4374,4524
info_cubo_RRHHidi_v13.md,"• Tipo de miembro en el grupo de investigación:
Permite agrupar a los investigadores en función de su relación con el grupo de investigación al que, en su ca pertenecen.",paragraph,169,33,4526,4695
info_cubo_RRHHidi_v13.md,">Valores posibles: investigador principal, colaborador, becario o externo a la UZ.",paragraph,82,16,4697,4779
info_cubo_RRHHidi_v13.md,## DIMENSION: Macroárea ##,paragraph,26,7,4781,4807
info_cubo_RRHHidi_v13.md,"Notas generales:
- Permite clasificar los datos en función de la macroárea a la que pertenecen los investigadores.",paragraph,114,20,4809,4923
info_cubo_RRHHidi_v13.md,">Valores posibles: Artes y Humanidades, Ciencias, Ciencias Sociales y Jurídicas, Ciencias de la Salud, Ingenier
Arquitectura.",paragraph,125,23,4925,5050
info_cubo_RRHHidi_v13.md,## DIMENSION: Nivel formativo ##,paragraph,32,8,5052,5084
info_cubo_RRHHidi_v13.md,"Notas generales:
- Permite clasificar los datos en función del nivel formativo de los investigadores.",paragraph,101,17,5086,5187
info_cubo_RRHHidi_v13.md,">Valores posibles: bachiller elemental o equivalente, bachiller superior o equivalente, diplomados o
equivalente, licenciados o equivalente, Máster (EEES), Doctor.",paragraph,163,29,5189,5352
info_cubo_RRHHidi_v13.md,## DIMENSION: Otros Centros de Investigación ##,paragraph,47,10,5354,5401
info_cubo_RRHHidi_v13.md,"Notas generales:
- Permite clasificar los datos en función de si los investigadores pertenecen o no a estructuras de investigació distintas a los institutos universitarios de investigación (por ejemplo: IIS - Instituto de Investigación Sanitaria Aragón).",paragraph,254,41,5403,5657
info_cubo_RRHHidi_v13.md,## DIMENSION: PAS o PDI ##,paragraph,26,9,5659,5685
info_cubo_RRHHidi_v13.md,"Notas generales:
- Permite clasificar a los investigadores en función de si figuran como PAS o PDI o BECARIOS en las bases de datos de personal. El valor ""no informado"" agrupa a los investigadores que no figuran en PeopleSoft.",paragraph,226,44,5687,5913
info_cubo_RRHHidi_v13.md,## DIMENSION: Participa Proyecto (S/N) ##,paragraph,41,11,5915,5956
info_cubo_RRHHidi_v13.md,"Notas generales:
- Permite clasificar a los investigadores en función de si figuran como participantes en un proyecto de I+D+i (S no (N).",paragraph,137,28,5958,6095
info_cubo_RRHHidi_v13.md,## DIMENSION: País Nacionalidad ##,paragraph,34,8,6097,6131
info_cubo_RRHHidi_v13.md,"Notas generales:
- Permite clasificar los datos en función del país de nacionalidad legal de los investigadores.",paragraph,112,19,6133,6245
info_cubo_RRHHidi_v13.md,## DIMENSION: Programa presupuestario ##,paragraph,40,8,6247,6287
info_cubo_RRHHidi_v13.md,"Notas generales:
- Permite clasificar los datos en función del programa presupuestario al que está asignado el puesto del investigador.",paragraph,135,22,6289,6424
info_cubo_RRHHidi_v13.md,## DIMENSION: Puesto de Investigación (S/N) ##,paragraph,46,12,6426,6472
info_cubo_RRHHidi_v13.md,"Notas generales:
- Permite distinguir si los investigadores ocupan un puesto de investigación (S) o no (N). Se considera que ocu un puesto de investigación si pertenecen a alguna categoría de investigador o si ocupan puestos asignados a programas presupuestarios de investigación (541-I, 148I, 171I, 417-I, 423-I, 425-I ó 450-I).",paragraph,329,64,6474,6803
info_cubo_RRHHidi_v13.md,## DIMENSION: Sexo del investigador ##,paragraph,38,9,6805,6843
info_cubo_RRHHidi_v13.md,"Notas generales:
- Permite agrupar a los investigadores en función de su sexo.",paragraph,78,15,6845,6923
info_cubo_RRHHidi_v13.md,## DIMENSION: TIEMPO ##,paragraph,23,7,6925,6948
info_cubo_RRHHidi_v13.md,"Notas generales:
- Permite ubicar en el tiempo la relación de los investigadores con la UZ. Se pueden desglosar los datos según año o el mes: • MES: se incluyen los investigadores existentes a fecha último día del mes seleccionado (si se trata de u mes en curso, se incluyen los investigadores existentes a la fecha de la última carga). • AÑO: se acumulan los investigadores existentes a fecha último día de todos los meses del año seleccionado (si el año seleccionado es un año en curso, se acumulan los efectivos existentes a fecha último día de los meses anteriores y para el mes en curso los efectivos existentes a la fecha de la últim carga).",paragraph,647,129,6950,7597
info_cubo_RRHHidi_v13.md,## DIMENSION: Tipo de Grupo de Investigación ##,paragraph,47,11,7599,7646
info_cubo_RRHHidi_v13.md,"Notas generales:
- Permite agrupar a los investigadores en función de la tipología del grupo de investigación al que, en su caso, pertenecen.",paragraph,141,27,7648,7789
info_cubo_RRHHidi_v13.md,">Valores posibles: Emergente, Consolidado, Consolidado de Investigación Aplicada, Excelente.",paragraph,92,15,7791,7883
info_cubo_RRHHidi_v13.md,## DIMENSION: Tramos ##,paragraph,23,7,7885,7908
info_cubo_RRHHidi_v13.md,"Atributos:
• Investigación Sexenios Estatales:
Permite clasificar los datos en función del número de sexenios o tramos de investigación reconocidos por la CNEAI a los investigadores. Se incluyen tanto los reconocidos a los cuerpos de funcionarios docentes universitarios como al personal contratado.",paragraph,299,46,7910,8209
info_cubo_RRHHidi_v13.md,"• Investigación Sexenios posibles:
Permite clasificar los funcionarios doctores en función del número de sexenios posibles.",paragraph,123,18,8211,8334
info_cubo_RRHHidi_v13.md,">Fórmula de cálculo: [año que se selecciona – (año de obtención del título de Doctor + 1)]/6 (redondeando
entero inferior)",paragraph,122,29,8336,8458
info_cubo_RRHHidi_v13.md,">En aquellos casos que no está informada la fecha de obtención del título de Doctor, se establece añadiend
la fecha de nacimiento 32,97 años (es, a fecha noviembre de 2013, la media de edad de obtención del título Doctor en la UZ de los empleados que sí tienen informada la fecha de obtención del título de Doctor).",paragraph,315,64,8460,8775
info_cubo_RRHHidi_v13.md,">Al poderse solicitar sexenios con carácter retrospectivo (méritos de investigación realizados en fechas
anteriores a la obtención del título de doctor) existe la posibilidad de que el número de sexenios posibles se inferior al número de sexenios conseguidos.",paragraph,259,42,8777,9036
info_cubo_RRHHidi_v13.md,"=== MEDIDAS ===

** Número de investigadores **
Número de investigadores en la Universidad de Zaragoza, entendiendo como tales: • todos los que participen en un proyecto de investigación • todos los que pertenezcan a un grupo de investigación • todos los que pertenezcan a instituto de investigación (ya sea un Instituto Universitario de Investigació otras estructuras de investigación, como el Instituto de Investigación Sanitaria de Aragón) • efectivos de PDI cuyos puestos estén asignados a un programa presupuestario de investigación o que tengan asignada como categoría del puesto alguna de las siguientes denominaciones: investigador, investigador en formación, investigador novel, doctor colaborador senior, doctor colaborador junior, investigador iniciado-experiencia, investigador iniciado, investigador predoctoral en formación.",sentence,838,130,0,838
info_cubo_RRHHidi_v13.md,• efectivos de PAS cuyos puestos estén asignados a un programa presupuestario de investigación o que tengan asignada como categoría del puesto la denominación “Titulado Superior-Proyectos de Investigación”.,sentence,206,31,838,1044
info_cubo_RRHHidi_v13.md,"• el personal de movilidad de entrada • el personal en formación (ayudas FPU, ayudas PIF, ayudas predoctorales, etc.)",sentence,117,25,1045,1162
info_cubo_RRHHidi_v13.md,">Nota: Se recomienda incorporar a la consulta la dimensión 'tiempo' para que se muestren los datos por añ
fecha concreta.",sentence,121,24,1163,1284
info_cubo_RRHHidi_v13.md,De lo contrario se acumularán todos los investigadores desde que existen datos.,sentence,79,13,1286,1365
info_cubo_RRHHidi_v13.md,"=== DIMENSIONES ===

## DIMENSION: Categoría Cuerpo Escala ##

Notas generales:
- Permite clasificar los datos en función de la categoría/cuerpo/escala a la que pertenecen los empleados.",sentence,186,32,1366,1552
info_cubo_RRHHidi_v13.md,"## DIMENSION: Categoría Investigador ##

Notas generales:
- Permite clasificar a los investigadores en función de la categoría que figura en su contrato de investigador.",sentence,169,30,1554,1723
info_cubo_RRHHidi_v13.md,"## DIMENSION: Centro ##

Notas generales:
- Permite clasificar los datos en función del centro al que pertenecen los investigadores.",sentence,132,25,1725,1857
info_cubo_RRHHidi_v13.md,"## DIMENSION: Departamento ##

Notas generales:
- Permite clasificar los datos en función del departamento al que están adscritos los investigadores.",sentence,149,26,1859,2008
info_cubo_RRHHidi_v13.md,"## DIMENSION: Doctor (S/N) ##

Notas generales:
- Permite clasificar a los investigadores en función de si figuran como Doctor en las bases de datos de persona (S) o no (N).",sentence,173,42,2010,2183
info_cubo_RRHHidi_v13.md,"## DIMENSION: Edad ##

Notas generales:
- Permite agrupar los rangos de edad de los investigadores en función de su fecha de nacimiento.",sentence,136,28,2185,2321
info_cubo_RRHHidi_v13.md,">Valores posibles: 20 años o menos, 21 a 30, 31 a 40, 41 a 50, 51 a 60, 60 años o más.",sentence,86,30,2323,2409
info_cubo_RRHHidi_v13.md,"## DIMENSION: Fecha de actualización ##

Notas generales:
- Indica la fecha de la última recarga de datos.",sentence,106,23,2411,2517
info_cubo_RRHHidi_v13.md,Habitualmente es el domingo anterior a la consulta de datos.,sentence,60,11,2519,2579
info_cubo_RRHHidi_v13.md,"## DIMENSION: Grupo de investigación ##

Notas generales:
- Permite clasificar los datos en función del grupo de investigación al que, en su caso, pertenecen los investigadores.",sentence,177,34,2580,2757
info_cubo_RRHHidi_v13.md,"Si no pertenecen a ningún grupo de investigación, figura “No informado”.",sentence,72,15,2759,2831
info_cubo_RRHHidi_v13.md,"## DIMENSION: Grupo gestionado UZ (S/N) ##

Notas generales:
- Permite clasificar los datos en función de si el grupo de investigación es gestionado desde la UZ (S) o es exte a la misma (N).",sentence,190,46,2832,3022
info_cubo_RRHHidi_v13.md,"## DIMENSION: Instituto de investigación ##

Notas generales:
- Permite clasificar los datos en función del instituto universitario de investigación (IUI) al que pertenecen los investigadores.",sentence,192,33,3024,3216
info_cubo_RRHHidi_v13.md,"Si no pertenecen a ningún IUI, figura “No informado”.",sentence,53,13,3218,3271
info_cubo_RRHHidi_v13.md,"## DIMENSION: Investigador ##

Atributos:
• Modalidad de personal:
Permite clasificar los investigadores en función de la modalidad de nombramiento o tipo de contrato.",sentence,167,30,3272,3439
info_cubo_RRHHidi_v13.md,">Valores posibles: de carrera, interino, indefinido fijo, indefinido no fijo, temporal, convencional (es el caso
los colaboradores extraordinarios y el de los eméritos).",sentence,169,33,3441,3610
info_cubo_RRHHidi_v13.md,">Se recomienda incorporar en la consulta la dimensión “PAS o PDI” para poder distinguir entre las diferente
modalidades.",sentence,120,22,3612,3732
info_cubo_RRHHidi_v13.md,"• Tesis dirigidas:
Permite clasificar los investigadores en función del número de tesis doctorales correspondientes a programa de doctorado regulados por el RD 99/2011 dirigidas o codirigidas en la fecha de consulta.",sentence,216,34,3734,3950
info_cubo_RRHHidi_v13.md,">Importante: en el caso de que una tesis doctoral haya sido dirigida por ‘n’ codirectores, se les adjudica a ca
uno de ellos el número de tesis ‘1/n’.",sentence,150,36,3952,4102
info_cubo_RRHHidi_v13.md,"• Tesis dirigidas con mención internacional:
Permite clasificar los investigadores en función del número de tesis doctorales con mención internacional correspondientes a programas de doctorado regulados por el RD 99/2011 dirigidas o codirigidas en la fecha consulta.",sentence,266,39,4104,4370
info_cubo_RRHHidi_v13.md,">Importante: en el caso de que una tesis doctoral haya sido dirigida por ‘n’ codirectores, se les adjudica a ca
uno de ellos el número de tesis ‘1/n’.",sentence,150,36,4372,4522
info_cubo_RRHHidi_v13.md,"• Tipo de miembro en el grupo de investigación:
Permite agrupar a los investigadores en función de su relación con el grupo de investigación al que, en su ca pertenecen.",sentence,169,33,4524,4693
info_cubo_RRHHidi_v13.md,">Valores posibles: investigador principal, colaborador, becario o externo a la UZ.",sentence,82,16,4695,4777
info_cubo_RRHHidi_v13.md,"## DIMENSION: Macroárea ##

Notas generales:
- Permite clasificar los datos en función de la macroárea a la que pertenecen los investigadores.",sentence,142,27,4779,4921
info_cubo_RRHHidi_v13.md,">Valores posibles: Artes y Humanidades, Ciencias, Ciencias Sociales y Jurídicas, Ciencias de la Salud, Ingenier
Arquitectura.",sentence,125,23,4923,5048
info_cubo_RRHHidi_v13.md,"## DIMENSION: Nivel formativo ##

Notas generales:
- Permite clasificar los datos en función del nivel formativo de los investigadores.",sentence,135,25,5050,5185
info_cubo_RRHHidi_v13.md,">Valores posibles: bachiller elemental o equivalente, bachiller superior o equivalente, diplomados o
equivalente, licenciados o equivalente, Máster (EEES), Doctor.",sentence,163,29,5187,5350
info_cubo_RRHHidi_v13.md,"## DIMENSION: Otros Centros de Investigación ##

Notas generales:
- Permite clasificar los datos en función de si los investigadores pertenecen o no a estructuras de investigació distintas a los institutos universitarios de investigación (por ejemplo: IIS - Instituto de Investigación Sanitaria Aragón).",sentence,303,51,5352,5655
info_cubo_RRHHidi_v13.md,"## DIMENSION: PAS o PDI ##

Notas generales:
- Permite clasificar a los investigadores en función de si figuran como PAS o PDI o BECARIOS en las bases de datos de personal.",sentence,172,37,5657,5829
info_cubo_RRHHidi_v13.md,"El valor ""no informado"" agrupa a los investigadores que no figuran en PeopleSoft.",sentence,81,16,5831,5912
info_cubo_RRHHidi_v13.md,"## DIMENSION: Participa Proyecto (S/N) ##

Notas generales:
- Permite clasificar a los investigadores en función de si figuran como participantes en un proyecto de I+D+i (S no (N).",sentence,180,39,5913,6093
info_cubo_RRHHidi_v13.md,"## DIMENSION: País Nacionalidad ##

Notas generales:
- Permite clasificar los datos en función del país de nacionalidad legal de los investigadores.",sentence,148,27,6095,6243
info_cubo_RRHHidi_v13.md,"## DIMENSION: Programa presupuestario ##

Notas generales:
- Permite clasificar los datos en función del programa presupuestario al que está asignado el puesto del investigador.",sentence,177,30,6245,6422
info_cubo_RRHHidi_v13.md,"## DIMENSION: Puesto de Investigación (S/N) ##

Notas generales:
- Permite distinguir si los investigadores ocupan un puesto de investigación (S) o no (N).",sentence,155,35,6424,6579
info_cubo_RRHHidi_v13.md,"Se considera que ocu un puesto de investigación si pertenecen a alguna categoría de investigador o si ocupan puestos asignados a programas presupuestarios de investigación (541-I, 148I, 171I, 417-I, 423-I, 425-I ó 450-I).",sentence,221,41,6581,6802
info_cubo_RRHHidi_v13.md,"## DIMENSION: Sexo del investigador ##

Notas generales:
- Permite agrupar a los investigadores en función de su sexo.",sentence,118,24,6803,6921
info_cubo_RRHHidi_v13.md,"## DIMENSION: TIEMPO ##

Notas generales:
- Permite ubicar en el tiempo la relación de los investigadores con la UZ.",sentence,116,25,6923,7039
info_cubo_RRHHidi_v13.md,"Se pueden desglosar los datos según año o el mes: • MES: se incluyen los investigadores existentes a fecha último día del mes seleccionado (si se trata de u mes en curso, se incluyen los investigadores existentes a la fecha de la última carga).",sentence,244,50,7041,7285
info_cubo_RRHHidi_v13.md,"• AÑO: se acumulan los investigadores existentes a fecha último día de todos los meses del año seleccionado (si el año seleccionado es un año en curso, se acumulan los efectivos existentes a fecha último día de los meses anteriores y para el mes en curso los efectivos existentes a la fecha de la últim carga).",sentence,310,61,7286,7596
info_cubo_RRHHidi_v13.md,"## DIMENSION: Tipo de Grupo de Investigación ##

Notas generales:
- Permite agrupar a los investigadores en función de la tipología del grupo de investigación al que, en su caso, pertenecen.",sentence,190,38,7597,7787
info_cubo_RRHHidi_v13.md,">Valores posibles: Emergente, Consolidado, Consolidado de Investigación Aplicada, Excelente.",sentence,92,15,7789,7881
info_cubo_RRHHidi_v13.md,"## DIMENSION: Tramos ##

Atributos:
• Investigación Sexenios Estatales:
Permite clasificar los datos en función del número de sexenios o tramos de investigación reconocidos por la CNEAI a los investigadores.",sentence,207,36,7883,8090
info_cubo_RRHHidi_v13.md,Se incluyen tanto los reconocidos a los cuerpos de funcionarios docentes universitarios como al personal contratado.,sentence,116,17,8092,8208
info_cubo_RRHHidi_v13.md,"• Investigación Sexenios posibles:
Permite clasificar los funcionarios doctores en función del número de sexenios posibles.",sentence,123,18,8209,8332
info_cubo_RRHHidi_v13.md,">Fórmula de cálculo: [año que se selecciona – (año de obtención del título de Doctor + 1)]/6 (redondeando
entero inferior)

>En aquellos casos que no está informada la fecha de obtención del título de Doctor, se establece añadiend
la fecha de nacimiento 32,97 años (es, a fecha noviembre de 2013, la media de edad de obtención del título Doctor en la UZ de los empleados que sí tienen informada la fecha de obtención del título de Doctor).",sentence,439,93,8334,8773
info_cubo_RRHHidi_v13.md,">Al poderse solicitar sexenios con carácter retrospectivo (méritos de investigación realizados en fechas
anteriores a la obtención del título de doctor) existe la posibilidad de que el número de sexenios posibles se inferior al número de sexenios conseguidos.",sentence,259,42,8775,9034
info_cubo_solicitudConvocatoria_v11.md,"=== MEDIDAS ===

** Total Solicitudes **
Número de solicitudes presentadas a convocatorias de proyectos de I+D+i.

>Se recomienda incorporar a la consulta la dimensión 'AÑO DE CONVOCATORIA' para que se muestren los
datos por año. De lo contrario se acumularán todas las solicitudes desde que existen datos.

** Importe solicitado **
Importe solicitado en una convocatoria de proyectos de I+D+i.

>Se recomienda incorporar a la consulta la dimensión 'AÑO DE CONVOCATORIA' para que se muestren los
datos por año. De lo contrario se acumularán todas las solicitudes desde que existen datos.

** Importe concedido **
Importe concedido en la resolución de una convocatoria de proyectos de I+D+i.

>Se recomienda incorporar a la consulta la dimensión 'AÑO DE CONVOCATORIA' para que se muestren los
datos por año. De lo contrario se acumularán todas las solicitudes desde que existen datos.

** Solicitudes concedidas **
Número de solicitudes concedidas en la resolución de las convocatorias de proyectos de I+D+i.

>Se recomienda incorporar a la consulta la dimensión 'AÑO DE CONVOCATORIA' para que se muestren los
datos por año. De lo contrario se acumularán todas las solicitudes desde que existen datos.

** Solicitudes denegadas **
Número de solicitudes denegadas en la resolución de las convocatorias de proyectos de I+D+i.

>Se recomienda incorporar a la consulta la dimensión 'AÑO DE CONVOCATORIA' para que se muestren los
datos por año. De lo contrario se acumularán todas las solicitudes desde que existen datos.

** Tasa de Éxito **
Es el cociente entre el número de solicitudes concedidas y el total de solicitudes.

>Se recomienda incorporar a la consulta la dimensión 'AÑO DE CONVOCATORIA' para que se muestren los
datos por año. De lo contrario se acumularán todas las solicitudes desde que existen datos.

** Tasa Éxito importes **
Es el cociente entre el importe concedido y el importe solicitado.

>Se recomienda incorporar a la consulta la dimensión 'AÑO DE CONVOCATORIA' para que se muestren los
datos por año. De lo contrario se acumularán todas las solicitudes desde que existen datos.",section,2101,383,0,2101
info_cubo_solicitudConvocatoria_v11.md,=== DIMENSIONES ===,section,20,3,2102,2122
info_cubo_solicitudConvocatoria_v11.md,"## DIMENSION: AÑO DE CONVOCATORIA ##

Notas generales:
- Permite clasificar los datos en función del año natural en que se realiza una convocatoria de proyecto de I+D+i.",section,170,33,2123,2293
info_cubo_solicitudConvocatoria_v11.md,"## DIMENSION: Convocatoria ##

Atributos:
• Alegación:
Indica si se han presentado alegaciones a la resolución provisional.

>Valores posibles: S (se han presentado alegaciones), N (no se han presentado alegaciones).

• Fecha de Resolución:
Permite clasificar los datos en función de la fecha (año, trimestre, mes o día) de resolución de la convocatoria.

• Oficina gestora:
Permite identificar las oficinas gestoras de Proyectos de I+D+i.

>Valores posibles: Oficina de Proyectos Europeos, Oficina de Transferencia de Resultados de Investigación,
Servicio de Gestión de la Investigación, Proyectos externos.

• Programa:
Clasifica las convocatorias según la Línea de actuación, el Programa y el Subprograma al que pertenecen.

• Tipo de convocatoria:
Clasifica las solicitudes según los siguientes valores: Grupos, Proyectos I+D+I, Proyectos colaborativos, Movilidades, Asesorías, Cursos y seminarios, Servicios técnicos, Recursos Humanos, Infraestructuras, Royalties/Licencias, Mecenazgo/Donaciones, CIT, Proyectos Colaborativos, Otros.

• Tipo de oportunidad:
Clasificación de las solicitudes según los siguientes valores:

>Valores posibles: Contrato, Convenio, Convocatoria, Subcontratación convocatoria.

• Ámbito territorial:
Permite clasificar los datos en función del ámbito geográfico de la convocatoria.

>Valores posibles: local, autonómico, nacional, europeo, internacional.",section,1388,241,2294,3682
info_cubo_solicitudConvocatoria_v11.md,"## DIMENSION: Fecha de actualización ##

Notas generales:
- Fecha de la última recarga de datos.",section,97,21,3683,3780
info_cubo_solicitudConvocatoria_v11.md,"## DIMENSION: Solicitante ##

Atributos:
• Centro:
Permite clasificar los datos en función del centro al que pertenece el solicitante del proyecto.

• Departamento:
Permite clasificar los datos en función del departamento al que está adscrito el solicitante del proyecto.

• Edad:
Permite agrupar los rangos de edad de los solicitantes en función de su fecha de nacimiento.

>Valores posibles: 20 años o menos, 21 a 30, 31 a 40, 41 a 50, 51 a 60, 60 años o más.

• Grupo de Investigación:
Permite clasificar los datos en función del grupo de investigación al que pertenece el solicitante del proyecto.

• Instituto:
Permite clasificar los datos en función del instituto universitario de investigación al que pertenece el solicitante del proyecto.

• Macroárea:
Permite clasificar los datos en función de la macroárea a la que pertenece el solicitante del proyecto.

>Valores posibles: Artes y Humanidades, Ciencias, Ciencias Sociales y Jurídicas, Ciencias de la Salud, Ingeniería
y Arquitectura.

• Otros Centros de Investigación:
Permite clasificar los datos en función de si los solicitantes del proyecto pertenecen o no a estructuras de investigación distintas de los institutos universitarios de investigación.

>Ejemplo: IIS ‐ Instituto de Investigación Sanitaria de Aragón.

• Sexo:
Permite clasificar a los solicitantes del proyecto en función de su sexo.

• Área:
Permite clasificar los datos en función del área de conocimiento a que pertenece el solicitante del proyecto.",section,1482,270,3781,5263
info_cubo_solicitudConvocatoria_v11.md,"## DIMENSION: Solicitud ##

Atributos:
• Concedido:
Permite identificar las solicitudes concedidas.

• Denegado:
Permite identificar las solicitudes denegadas.

• Fecha:
Permite clasificar los datos en función de la fecha (año, trimestre, mes o día) de solicitud.",section,265,51,5264,5529
info_cubo_solicitudConvocatoria_v11.md,=== MEDIDAS ===,paragraph,15,3,0,15
info_cubo_solicitudConvocatoria_v11.md,"** Total Solicitudes **
Número de solicitudes presentadas a convocatorias de proyectos de I+D+i.",paragraph,96,17,17,113
info_cubo_solicitudConvocatoria_v11.md,">Se recomienda incorporar a la consulta la dimensión 'AÑO DE CONVOCATORIA' para que se muestren los
datos por año. De lo contrario se acumularán todas las solicitudes desde que existen datos.",paragraph,191,35,115,306
info_cubo_solicitudConvocatoria_v11.md,"** Importe solicitado **
Importe solicitado en una convocatoria de proyectos de I+D+i.",paragraph,86,16,308,394
info_cubo_solicitudConvocatoria_v11.md,">Se recomienda incorporar a la consulta la dimensión 'AÑO DE CONVOCATORIA' para que se muestren los
datos por año. De lo contrario se acumularán todas las solicitudes desde que existen datos.",paragraph,191,35,396,587
info_cubo_solicitudConvocatoria_v11.md,"** Importe concedido **
Importe concedido en la resolución de una convocatoria de proyectos de I+D+i.",paragraph,101,19,589,690
info_cubo_solicitudConvocatoria_v11.md,">Se recomienda incorporar a la consulta la dimensión 'AÑO DE CONVOCATORIA' para que se muestren los
datos por año. De lo contrario se acumularán todas las solicitudes desde que existen datos.",paragraph,191,35,692,883
info_cubo_solicitudConvocatoria_v11.md,"** Solicitudes concedidas **
Número de solicitudes concedidas en la resolución de las convocatorias de proyectos de I+D+i.",paragraph,122,21,885,1007
info_cubo_solicitudConvocatoria_v11.md,">Se recomienda incorporar a la consulta la dimensión 'AÑO DE CONVOCATORIA' para que se muestren los
datos por año. De lo contrario se acumularán todas las solicitudes desde que existen datos.",paragraph,191,35,1009,1200
info_cubo_solicitudConvocatoria_v11.md,"** Solicitudes denegadas **
Número de solicitudes denegadas en la resolución de las convocatorias de proyectos de I+D+i.",paragraph,120,21,1202,1322
info_cubo_solicitudConvocatoria_v11.md,">Se recomienda incorporar a la consulta la dimensión 'AÑO DE CONVOCATORIA' para que se muestren los
datos por año. De lo contrario se acumularán todas las solicitudes desde que existen datos.",paragraph,191,35,1324,1515
info_cubo_solicitudConvocatoria_v11.md,"** Tasa de Éxito **
Es el cociente entre el número de solicitudes concedidas y el total de solicitudes.",paragraph,103,22,1517,1620
info_cubo_solicitudConvocatoria_v11.md,">Se recomienda incorporar a la consulta la dimensión 'AÑO DE CONVOCATORIA' para que se muestren los
datos por año. De lo contrario se acumularán todas las solicitudes desde que existen datos.",paragraph,191,35,1622,1813
info_cubo_solicitudConvocatoria_v11.md,"** Tasa Éxito importes **
Es el cociente entre el importe concedido y el importe solicitado.",paragraph,92,19,1815,1907
info_cubo_solicitudConvocatoria_v11.md,">Se recomienda incorporar a la consulta la dimensión 'AÑO DE CONVOCATORIA' para que se muestren los
datos por año. De lo contrario se acumularán todas las solicitudes desde que existen datos.",paragraph,191,35,1909,2100
info_cubo_solicitudConvocatoria_v11.md,=== DIMENSIONES ===,paragraph,19,3,2102,2121
info_cubo_solicitudConvocatoria_v11.md,## DIMENSION: AÑO DE CONVOCATORIA ##,paragraph,36,9,2123,2159
info_cubo_solicitudConvocatoria_v11.md,"Notas generales:
- Permite clasificar los datos en función del año natural en que se realiza una convocatoria de proyecto de I+D+i.",paragraph,131,24,2161,2292
info_cubo_solicitudConvocatoria_v11.md,## DIMENSION: Convocatoria ##,paragraph,29,7,2294,2323
info_cubo_solicitudConvocatoria_v11.md,"Atributos:
• Alegación:
Indica si se han presentado alegaciones a la resolución provisional.",paragraph,92,16,2325,2417
info_cubo_solicitudConvocatoria_v11.md,">Valores posibles: S (se han presentado alegaciones), N (no se han presentado alegaciones).",paragraph,91,21,2419,2510
info_cubo_solicitudConvocatoria_v11.md,"• Fecha de Resolución:
Permite clasificar los datos en función de la fecha (año, trimestre, mes o día) de resolución de la convocatoria.",paragraph,136,29,2512,2648
info_cubo_solicitudConvocatoria_v11.md,"• Oficina gestora:
Permite identificar las oficinas gestoras de Proyectos de I+D+i.",paragraph,83,14,2650,2733
info_cubo_solicitudConvocatoria_v11.md,">Valores posibles: Oficina de Proyectos Europeos, Oficina de Transferencia de Resultados de Investigación,
Servicio de Gestión de la Investigación, Proyectos externos.",paragraph,167,27,2735,2902
info_cubo_solicitudConvocatoria_v11.md,"• Programa:
Clasifica las convocatorias según la Línea de actuación, el Programa y el Subprograma al que pertenecen.",paragraph,116,21,2904,3020
info_cubo_solicitudConvocatoria_v11.md,"• Tipo de convocatoria:
Clasifica las solicitudes según los siguientes valores: Grupos, Proyectos I+D+I, Proyectos colaborativos, Movilidades, Asesorías, Cursos y seminarios, Servicios técnicos, Recursos Humanos, Infraestructuras, Royalties/Licencias, Mecenazgo/Donaciones, CIT, Proyectos Colaborativos, Otros.",paragraph,310,48,3022,3332
info_cubo_solicitudConvocatoria_v11.md,"• Tipo de oportunidad:
Clasificación de las solicitudes según los siguientes valores:",paragraph,85,14,3334,3419
info_cubo_solicitudConvocatoria_v11.md,">Valores posibles: Contrato, Convenio, Convocatoria, Subcontratación convocatoria.",paragraph,82,13,3421,3503
info_cubo_solicitudConvocatoria_v11.md,"• Ámbito territorial:
Permite clasificar los datos en función del ámbito geográfico de la convocatoria.",paragraph,103,17,3505,3608
info_cubo_solicitudConvocatoria_v11.md,">Valores posibles: local, autonómico, nacional, europeo, internacional.",paragraph,71,14,3610,3681
info_cubo_solicitudConvocatoria_v11.md,## DIMENSION: Fecha de actualización ##,paragraph,39,9,3683,3722
info_cubo_solicitudConvocatoria_v11.md,"Notas generales:
- Fecha de la última recarga de datos.",paragraph,55,12,3724,3779
info_cubo_solicitudConvocatoria_v11.md,## DIMENSION: Solicitante ##,paragraph,28,7,3781,3809
info_cubo_solicitudConvocatoria_v11.md,"Atributos:
• Centro:
Permite clasificar los datos en función del centro al que pertenece el solicitante del proyecto.",paragraph,117,21,3811,3928
info_cubo_solicitudConvocatoria_v11.md,"• Departamento:
Permite clasificar los datos en función del departamento al que está adscrito el solicitante del proyecto.",paragraph,122,20,3930,4052
info_cubo_solicitudConvocatoria_v11.md,"• Edad:
Permite agrupar los rangos de edad de los solicitantes en función de su fecha de nacimiento.",paragraph,100,20,4054,4154
info_cubo_solicitudConvocatoria_v11.md,">Valores posibles: 20 años o menos, 21 a 30, 31 a 40, 41 a 50, 51 a 60, 60 años o más.",paragraph,86,30,4156,4242
info_cubo_solicitudConvocatoria_v11.md,"• Grupo de Investigación:
Permite clasificar los datos en función del grupo de investigación al que pertenece el solicitante del proyecto.",paragraph,138,23,4244,4382
info_cubo_solicitudConvocatoria_v11.md,"• Instituto:
Permite clasificar los datos en función del instituto universitario de investigación al que pertenece el solicitante del proyecto.",paragraph,143,22,4384,4527
info_cubo_solicitudConvocatoria_v11.md,"• Macroárea:
Permite clasificar los datos en función de la macroárea a la que pertenece el solicitante del proyecto.",paragraph,116,21,4529,4645
info_cubo_solicitudConvocatoria_v11.md,">Valores posibles: Artes y Humanidades, Ciencias, Ciencias Sociales y Jurídicas, Ciencias de la Salud, Ingeniería
y Arquitectura.",paragraph,129,24,4647,4776
info_cubo_solicitudConvocatoria_v11.md,"• Otros Centros de Investigación:
Permite clasificar los datos en función de si los solicitantes del proyecto pertenecen o no a estructuras de investigación distintas de los institutos universitarios de investigación.",paragraph,217,33,4778,4995
info_cubo_solicitudConvocatoria_v11.md,>Ejemplo: IIS ‐ Instituto de Investigación Sanitaria de Aragón.,paragraph,63,12,4997,5060
info_cubo_solicitudConvocatoria_v11.md,"• Sexo:
Permite clasificar a los solicitantes del proyecto en función de su sexo.",paragraph,81,16,5062,5143
info_cubo_solicitudConvocatoria_v11.md,"• Área:
Permite clasificar los datos en función del área de conocimiento a que pertenece el solicitante del proyecto.",paragraph,117,21,5145,5262
info_cubo_solicitudConvocatoria_v11.md,## DIMENSION: Solicitud ##,paragraph,26,7,5264,5290
info_cubo_solicitudConvocatoria_v11.md,"Atributos:
• Concedido:
Permite identificar las solicitudes concedidas.",paragraph,71,11,5292,5363
info_cubo_solicitudConvocatoria_v11.md,"• Denegado:
Permite identificar las solicitudes denegadas.",paragraph,58,9,5365,5423
info_cubo_solicitudConvocatoria_v11.md,"• Fecha:
Permite clasificar los datos en función de la fecha (año, trimestre, mes o día) de solicitud.",paragraph,102,24,5425,5527
info_cubo_solicitudConvocatoria_v11.md,"=== MEDIDAS ===

** Total Solicitudes **
Número de solicitudes presentadas a convocatorias de proyectos de I+D+i.",sentence,113,20,0,113
info_cubo_solicitudConvocatoria_v11.md,">Se recomienda incorporar a la consulta la dimensión 'AÑO DE CONVOCATORIA' para que se muestren los
datos por año.",sentence,114,22,113,227
info_cubo_solicitudConvocatoria_v11.md,De lo contrario se acumularán todas las solicitudes desde que existen datos.,sentence,76,13,229,305
info_cubo_solicitudConvocatoria_v11.md,"** Importe solicitado **
Importe solicitado en una convocatoria de proyectos de I+D+i.",sentence,86,16,306,392
info_cubo_solicitudConvocatoria_v11.md,">Se recomienda incorporar a la consulta la dimensión 'AÑO DE CONVOCATORIA' para que se muestren los
datos por año.",sentence,114,22,394,508
info_cubo_solicitudConvocatoria_v11.md,De lo contrario se acumularán todas las solicitudes desde que existen datos.,sentence,76,13,510,586
info_cubo_solicitudConvocatoria_v11.md,"** Importe concedido **
Importe concedido en la resolución de una convocatoria de proyectos de I+D+i.",sentence,101,19,587,688
info_cubo_solicitudConvocatoria_v11.md,">Se recomienda incorporar a la consulta la dimensión 'AÑO DE CONVOCATORIA' para que se muestren los
datos por año.",sentence,114,22,690,804
info_cubo_solicitudConvocatoria_v11.md,De lo contrario se acumularán todas las solicitudes desde que existen datos.,sentence,76,13,806,882
info_cubo_solicitudConvocatoria_v11.md,"** Solicitudes concedidas **
Número de solicitudes concedidas en la resolución de las convocatorias de proyectos de I+D+i.",sentence,122,21,883,1005
info_cubo_solicitudConvocatoria_v11.md,">Se recomienda incorporar a la consulta la dimensión 'AÑO DE CONVOCATORIA' para que se muestren los
datos por año.",sentence,114,22,1007,1121
info_cubo_solicitudConvocatoria_v11.md,De lo contrario se acumularán todas las solicitudes desde que existen datos.,sentence,76,13,1123,1199
info_cubo_solicitudConvocatoria_v11.md,"** Solicitudes denegadas **
Número de solicitudes denegadas en la resolución de las convocatorias de proyectos de I+D+i.",sentence,120,21,1200,1320
info_cubo_solicitudConvocatoria_v11.md,">Se recomienda incorporar a la consulta la dimensión 'AÑO DE CONVOCATORIA' para que se muestren los
datos por año.",sentence,114,22,1322,1436
info_cubo_solicitudConvocatoria_v11.md,De lo contrario se acumularán todas las solicitudes desde que existen datos.,sentence,76,13,1438,1514
info_cubo_solicitudConvocatoria_v11.md,"** Tasa de Éxito **
Es el cociente entre el número de solicitudes concedidas y el total de solicitudes.",sentence,103,22,1515,1618
info_cubo_solicitudConvocatoria_v11.md,">Se recomienda incorporar a la consulta la dimensión 'AÑO DE CONVOCATORIA' para que se muestren los
datos por año.",sentence,114,22,1620,1734
info_cubo_solicitudConvocatoria_v11.md,De lo contrario se acumularán todas las solicitudes desde que existen datos.,sentence,76,13,1736,1812
info_cubo_solicitudConvocatoria_v11.md,"** Tasa Éxito importes **
Es el cociente entre el importe concedido y el importe solicitado.",sentence,92,19,1813,1905
info_cubo_solicitudConvocatoria_v11.md,">Se recomienda incorporar a la consulta la dimensión 'AÑO DE CONVOCATORIA' para que se muestren los
datos por año.",sentence,114,22,1907,2021
info_cubo_solicitudConvocatoria_v11.md,De lo contrario se acumularán todas las solicitudes desde que existen datos.,sentence,76,13,2023,2099
info_cubo_solicitudConvocatoria_v11.md,"=== DIMENSIONES ===

## DIMENSION: AÑO DE CONVOCATORIA ##

Notas generales:
- Permite clasificar los datos en función del año natural en que se realiza una convocatoria de proyecto de I+D+i.",sentence,190,36,2100,2290
info_cubo_solicitudConvocatoria_v11.md,"## DIMENSION: Convocatoria ##

Atributos:
• Alegación:
Indica si se han presentado alegaciones a la resolución provisional.",sentence,123,23,2292,2415
info_cubo_solicitudConvocatoria_v11.md,">Valores posibles: S (se han presentado alegaciones), N (no se han presentado alegaciones).",sentence,91,21,2417,2508
info_cubo_solicitudConvocatoria_v11.md,"• Fecha de Resolución:
Permite clasificar los datos en función de la fecha (año, trimestre, mes o día) de resolución de la convocatoria.",sentence,136,29,2510,2646
info_cubo_solicitudConvocatoria_v11.md,"• Oficina gestora:
Permite identificar las oficinas gestoras de Proyectos de I+D+i.",sentence,83,14,2648,2731
info_cubo_solicitudConvocatoria_v11.md,">Valores posibles: Oficina de Proyectos Europeos, Oficina de Transferencia de Resultados de Investigación,
Servicio de Gestión de la Investigación, Proyectos externos.",sentence,167,27,2733,2900
info_cubo_solicitudConvocatoria_v11.md,"• Programa:
Clasifica las convocatorias según la Línea de actuación, el Programa y el Subprograma al que pertenecen.",sentence,116,21,2902,3018
info_cubo_solicitudConvocatoria_v11.md,"• Tipo de convocatoria:
Clasifica las solicitudes según los siguientes valores: Grupos, Proyectos I+D+I, Proyectos colaborativos, Movilidades, Asesorías, Cursos y seminarios, Servicios técnicos, Recursos Humanos, Infraestructuras, Royalties/Licencias, Mecenazgo/Donaciones, CIT, Proyectos Colaborativos, Otros.",sentence,310,48,3020,3330
info_cubo_solicitudConvocatoria_v11.md,"• Tipo de oportunidad:
Clasificación de las solicitudes según los siguientes valores:

>Valores posibles: Contrato, Convenio, Convocatoria, Subcontratación convocatoria.",sentence,169,27,3332,3501
info_cubo_solicitudConvocatoria_v11.md,"• Ámbito territorial:
Permite clasificar los datos en función del ámbito geográfico de la convocatoria.",sentence,103,17,3503,3606
info_cubo_solicitudConvocatoria_v11.md,">Valores posibles: local, autonómico, nacional, europeo, internacional.",sentence,71,14,3608,3679
info_cubo_solicitudConvocatoria_v11.md,"## DIMENSION: Fecha de actualización ##

Notas generales:
- Fecha de la última recarga de datos.",sentence,96,21,3681,3777
info_cubo_solicitudConvocatoria_v11.md,"## DIMENSION: Solicitante ##

Atributos:
• Centro:
Permite clasificar los datos en función del centro al que pertenece el solicitante del proyecto.",sentence,147,28,3779,3926
info_cubo_solicitudConvocatoria_v11.md,"• Departamento:
Permite clasificar los datos en función del departamento al que está adscrito el solicitante del proyecto.",sentence,122,20,3928,4050
info_cubo_solicitudConvocatoria_v11.md,"• Edad:
Permite agrupar los rangos de edad de los solicitantes en función de su fecha de nacimiento.",sentence,100,20,4052,4152
info_cubo_solicitudConvocatoria_v11.md,">Valores posibles: 20 años o menos, 21 a 30, 31 a 40, 41 a 50, 51 a 60, 60 años o más.",sentence,86,30,4154,4240
info_cubo_solicitudConvocatoria_v11.md,"• Grupo de Investigación:
Permite clasificar los datos en función del grupo de investigación al que pertenece el solicitante del proyecto.",sentence,138,23,4242,4380
info_cubo_solicitudConvocatoria_v11.md,"• Instituto:
Permite clasificar los datos en función del instituto universitario de investigación al que pertenece el solicitante del proyecto.",sentence,143,22,4382,4525
info_cubo_solicitudConvocatoria_v11.md,"• Macroárea:
Permite clasificar los datos en función de la macroárea a la que pertenece el solicitante del proyecto.",sentence,116,21,4527,4643
info_cubo_solicitudConvocatoria_v11.md,">Valores posibles: Artes y Humanidades, Ciencias, Ciencias Sociales y Jurídicas, Ciencias de la Salud, Ingeniería
y Arquitectura.",sentence,129,24,4645,4774
info_cubo_solicitudConvocatoria_v11.md,"• Otros Centros de Investigación:
Permite clasificar los datos en función de si los solicitantes del proyecto pertenecen o no a estructuras de investigación distintas de los institutos universitarios de investigación.",sentence,217,33,4776,4993
info_cubo_solicitudConvocatoria_v11.md,>Ejemplo: IIS ‐ Instituto de Investigación Sanitaria de Aragón.,sentence,63,12,4995,5058
info_cubo_solicitudConvocatoria_v11.md,"• Sexo:
Permite clasificar a los solicitantes del proyecto en función de su sexo.",sentence,81,16,5060,5141
info_cubo_solicitudConvocatoria_v11.md,"• Área:
Permite clasificar los datos en función del área de conocimiento a que pertenece el solicitante del proyecto.",sentence,117,21,5143,5260
info_cubo_solicitudConvocatoria_v11.md,"## DIMENSION: Solicitud ##

Atributos:
• Concedido:
Permite identificar las solicitudes concedidas.",sentence,99,18,5262,5361
info_cubo_solicitudConvocatoria_v11.md,"• Denegado:
Permite identificar las solicitudes denegadas.",sentence,58,9,5363,5421
info_cubo_solicitudConvocatoria_v11.md,"• Fecha:
Permite clasificar los datos en función de la fecha (año, trimestre, mes o día) de solicitud.",sentence,102,24,5423,5525
info_cubo_solicitudes_movilidad_OUT_v11.md,"=== MEDIDAS ===

** Total solicitudes **
Número total de solicitudes de movilidad presentadas por estudiantes de Unizar para realizar una estancia temporal en otra universidad, en el marco de los acuerdos bilaterales o programas de movilidad suscritos po Unizar. El intercambio debe ir asociado a algún tipo de reconocimiento académico.

>Nota: sólo se contabilizan las solicitudes de programas de intercambio que tienen informados en SIGMA tod
los datos correspondientes a la solicitud del alumno, a la asignación de plaza y al contrato de estudios. Por tanto, se muestran datos correspondientes a los programas ERASMUS y SICUE desde el curso 2008/09, de Movilidad UE-Suiza desde el curso 2014/15, y de UZ/NOA y Movilidad Iberoamérica desde el curso 2016/17.

** Total solicitudes aceptadas **
Número total de solicitudes de movilidad (ver definición de “total solicitudes”) a las que se asigna plaza.

** Total renuncias **
Número total de solicitudes aceptadas que no se han hecho efectivas, ya sea por renuncia expresa o tácita.",section,1033,186,0,1033
info_cubo_solicitudes_movilidad_OUT_v11.md,=== DIMENSIONES ===,section,20,3,1034,1054
info_cubo_solicitudes_movilidad_OUT_v11.md,"## DIMENSION: Alumno ##

Atributos:
• Nacionalidad:
Permite clasificar los datos en función de la nacionalidad legal de los estudiantes.

• Rango de edad:
Permite clasificar los datos en función de los rangos de edad de los estudiantes a fecha 31 de diciembre del curso académico en que están matriculados.

>Valores posibles: 18 años o menos, 19, 20, 21, 22, 23, 24, 25, 26, 27, 28, 29, 30 a 34, 35 a 39, 40 a 44, 45 a 4
50 a 54, 55 a 59, 60 a 64, 65 años o más.

• Residencia Familiar:
Identifica el país, la comunidad autónoma, la provincia o la población de residencia familiar informada por lo estudiantes.

• Sexo:
Permite agrupar a los estudiantes en función de su sexo.",section,678,160,1055,1733
info_cubo_solicitudes_movilidad_OUT_v11.md,"## DIMENSION: CURSO ACADÉMICO ##

Notas generales:
- Clasifica los datos en función del curso académico para el que los estudiantes formulan sus solicitudes de movilidad.

>Nota: El primer curso académico del que constan datos es el 2008/09.",section,242,46,1734,1976
info_cubo_solicitudes_movilidad_OUT_v11.md,"## DIMENSION: Centro ##

Notas generales:
- Permite clasificar los datos en función del centro de Unizar en que los estudiantes están matriculados en el curso académico para el que formulan su solicitud de movilidad.",section,217,40,1977,2194
info_cubo_solicitudes_movilidad_OUT_v11.md,"## DIMENSION: Expediente ##

Atributos:
• Créditos Superados Previos:
Permite identificar los rangos de créditos superados por los estudiantes en Unizar previamente a formular su solicitud de movilidad.

>Valores posibles: 0 créditos, de 1 a 50 créditos, de 51 a 100 créditos, etc.

• Cursos Matriculados:
Permite clasificar los datos en función del número de cursos en que se han matriculado los estudiantes en la titulación hasta el momento de formular su solicitud de movilidad.",section,482,89,2195,2677
info_cubo_solicitudes_movilidad_OUT_v11.md,"## DIMENSION: Fecha de actualización ##

Notas generales:
- Indica la fecha de la última recarga de datos. Habitualmente se realiza el domingo anterior a la fecha de consulta de datos.",section,185,37,2678,2863
info_cubo_solicitudes_movilidad_OUT_v11.md,"## DIMENSION: Movilidad ##

Atributos:
• Idioma:
Permite clasificar los datos en función del idioma que consta en el contrato de estudios para la movilidad.

>Nota: esta dimensión solamente figura informada para movilidades efectivas del programa Erasmus.

• Nivel de Estudios:
Permite identificar el nivel formativo de los estudiantes que solicitan la movilidad.

>Valores posibles: Undergraduate, Undergraduate/Postgraduate, Undergraduate/Doctoral,
Undergraduate/Postgraduate/Doctoral, Postgraduate, Postgraduate/Doctoral.

• Orden de Preferencia:
Permite clasificar los datos en función del orden de preferencia consignado por los estudiantes al solicitar los destinos de la movilidad.

• País de la Universidad de Destino:
Permite clasificar los datos en función de los países de pertenencia de las universidades de destino para las q los estudiantes solicitan la estancia.

• Preferencia Aceptada (S/N):
Permite distinguir entre aquellas preferencias de solicitudes de movilidad que han sido aceptadas (S) y las qu no (N).

• Programa de Movilidad:
Permite clasificar los datos en función del programa de movilidad en virtud del cual se formula la solicitud de movilidad.

• Renuncia (S/N):
Permite distinguir entre las solicitudes de movilidad aceptadas que no se han hecho efectivas (S) de las que s se han hecho efectivas (N).

• Universidad de Destino:
Permite clasificar los datos en función de la universidad para la que los estudiantes formulan la solicitud de movilidad.

• Universidad de Destino UNITA (S/N):
Permite clasificar los datos en función de si la universidad para la que los estudiantes formulan la solicitud de movilidad pertenece a la alianza de universidades europeas UNITA (S) o no (N).

>El primer curso académico en que están registradas universidades UNITA es 2020/21.

• Área de Estudios:
Permite identificar el área de estudios o ámbito para el que se establece el acuerdo de movilidad en que se ofertan las plazas solicitadas por los estudiantes.",section,1982,350,2864,4846
info_cubo_solicitudes_movilidad_OUT_v11.md,"## DIMENSION: Titulación ##

Atributos:
• Estudio:
Permite clasificar a los estudiantes en función del estudio que cursan en Unizar. Es adecuado si queremos agrupar los datos de los estudios que se imparten en varias localidades (ejemplo: ADE, Enfermería, Magisteri Medicina, etc.).

• Plan de Estudios:
Permite clasificar los datos en función del plan de estudios (código y denominación) cursado por los estudian en Unizar.

• Rama de Conocimiento:
Permite clasificar los datos en función de la Rama de Conocimiento (Artes y Humanidades, Ciencias, Ciencias Sociales y Jurídicas, Ciencias de la Salud, Ingeniería y Arquitectura) a la que pertenece el estudio cursado por estudiantes en Unizar.

• Tipo de Estudio:
Permite identificar el tipo de estudio cursado por los estudiantes en Unizar: grado, máster, doctorado. Con anterioridad al curso 2014/15 se muestran también licenciatura o equivalente, diplomatura o equivalent",section,926,170,4847,5773
info_cubo_solicitudes_movilidad_OUT_v11.md,=== MEDIDAS ===,paragraph,15,3,0,15
info_cubo_solicitudes_movilidad_OUT_v11.md,"** Total solicitudes **
Número total de solicitudes de movilidad presentadas por estudiantes de Unizar para realizar una estancia temporal en otra universidad, en el marco de los acuerdos bilaterales o programas de movilidad suscritos po Unizar. El intercambio debe ir asociado a algún tipo de reconocimiento académico.",paragraph,319,53,17,336
info_cubo_solicitudes_movilidad_OUT_v11.md,">Nota: sólo se contabilizan las solicitudes de programas de intercambio que tienen informados en SIGMA tod
los datos correspondientes a la solicitud del alumno, a la asignación de plaza y al contrato de estudios. Por tanto, se muestran datos correspondientes a los programas ERASMUS y SICUE desde el curso 2008/09, de Movilidad UE-Suiza desde el curso 2014/15, y de UZ/NOA y Movilidad Iberoamérica desde el curso 2016/17.",paragraph,421,75,338,759
info_cubo_solicitudes_movilidad_OUT_v11.md,"** Total solicitudes aceptadas **
Número total de solicitudes de movilidad (ver definición de “total solicitudes”) a las que se asigna plaza.",paragraph,141,29,761,902
info_cubo_solicitudes_movilidad_OUT_v11.md,"** Total renuncias **
Número total de solicitudes aceptadas que no se han hecho efectivas, ya sea por renuncia expresa o tácita.",paragraph,128,26,904,1032
info_cubo_solicitudes_movilidad_OUT_v11.md,=== DIMENSIONES ===,paragraph,19,3,1034,1053
info_cubo_solicitudes_movilidad_OUT_v11.md,## DIMENSION: Alumno ##,paragraph,23,7,1055,1078
info_cubo_solicitudes_movilidad_OUT_v11.md,"Atributos:
• Nacionalidad:
Permite clasificar los datos en función de la nacionalidad legal de los estudiantes.",paragraph,111,19,1080,1191
info_cubo_solicitudes_movilidad_OUT_v11.md,"• Rango de edad:
Permite clasificar los datos en función de los rangos de edad de los estudiantes a fecha 31 de diciembre del curso académico en que están matriculados.",paragraph,168,32,1193,1361
info_cubo_solicitudes_movilidad_OUT_v11.md,">Valores posibles: 18 años o menos, 19, 20, 21, 22, 23, 24, 25, 26, 27, 28, 29, 30 a 34, 35 a 39, 40 a 44, 45 a 4
50 a 54, 55 a 59, 60 a 64, 65 años o más.",paragraph,155,63,1363,1518
info_cubo_solicitudes_movilidad_OUT_v11.md,"• Residencia Familiar:
Identifica el país, la comunidad autónoma, la provincia o la población de residencia familiar informada por lo estudiantes.",paragraph,146,25,1520,1666
info_cubo_solicitudes_movilidad_OUT_v11.md,"• Sexo:
Permite agrupar a los estudiantes en función de su sexo.",paragraph,64,14,1668,1732
info_cubo_solicitudes_movilidad_OUT_v11.md,## DIMENSION: CURSO ACADÉMICO ##,paragraph,32,8,1734,1766
info_cubo_solicitudes_movilidad_OUT_v11.md,"Notas generales:
- Clasifica los datos en función del curso académico para el que los estudiantes formulan sus solicitudes de movilidad.",paragraph,136,23,1768,1904
info_cubo_solicitudes_movilidad_OUT_v11.md,>Nota: El primer curso académico del que constan datos es el 2008/09.,paragraph,69,15,1906,1975
info_cubo_solicitudes_movilidad_OUT_v11.md,## DIMENSION: Centro ##,paragraph,23,7,1977,2000
info_cubo_solicitudes_movilidad_OUT_v11.md,"Notas generales:
- Permite clasificar los datos en función del centro de Unizar en que los estudiantes están matriculados en el curso académico para el que formulan su solicitud de movilidad.",paragraph,191,33,2002,2193
info_cubo_solicitudes_movilidad_OUT_v11.md,## DIMENSION: Expediente ##,paragraph,27,7,2195,2222
info_cubo_solicitudes_movilidad_OUT_v11.md,"Atributos:
• Créditos Superados Previos:
Permite identificar los rangos de créditos superados por los estudiantes en Unizar previamente a formular su solicitud de movilidad.",paragraph,173,27,2224,2397
info_cubo_solicitudes_movilidad_OUT_v11.md,">Valores posibles: 0 créditos, de 1 a 50 créditos, de 51 a 100 créditos, etc.",paragraph,77,21,2399,2476
info_cubo_solicitudes_movilidad_OUT_v11.md,"• Cursos Matriculados:
Permite clasificar los datos en función del número de cursos en que se han matriculado los estudiantes en la titulación hasta el momento de formular su solicitud de movilidad.",paragraph,198,34,2478,2676
info_cubo_solicitudes_movilidad_OUT_v11.md,## DIMENSION: Fecha de actualización ##,paragraph,39,9,2678,2717
info_cubo_solicitudes_movilidad_OUT_v11.md,"Notas generales:
- Indica la fecha de la última recarga de datos. Habitualmente se realiza el domingo anterior a la fecha de consulta de datos.",paragraph,143,28,2719,2862
info_cubo_solicitudes_movilidad_OUT_v11.md,## DIMENSION: Movilidad ##,paragraph,26,7,2864,2890
info_cubo_solicitudes_movilidad_OUT_v11.md,"Atributos:
• Idioma:
Permite clasificar los datos en función del idioma que consta en el contrato de estudios para la movilidad.",paragraph,128,24,2892,3020
info_cubo_solicitudes_movilidad_OUT_v11.md,>Nota: esta dimensión solamente figura informada para movilidades efectivas del programa Erasmus.,paragraph,97,15,3022,3119
info_cubo_solicitudes_movilidad_OUT_v11.md,"• Nivel de Estudios:
Permite identificar el nivel formativo de los estudiantes que solicitan la movilidad.",paragraph,106,18,3121,3227
info_cubo_solicitudes_movilidad_OUT_v11.md,">Valores posibles: Undergraduate, Undergraduate/Postgraduate, Undergraduate/Doctoral,
Undergraduate/Postgraduate/Doctoral, Postgraduate, Postgraduate/Doctoral.",paragraph,159,16,3229,3388
info_cubo_solicitudes_movilidad_OUT_v11.md,"• Orden de Preferencia:
Permite clasificar los datos en función del orden de preferencia consignado por los estudiantes al solicitar los destinos de la movilidad.",paragraph,162,27,3390,3552
info_cubo_solicitudes_movilidad_OUT_v11.md,"• País de la Universidad de Destino:
Permite clasificar los datos en función de los países de pertenencia de las universidades de destino para las q los estudiantes solicitan la estancia.",paragraph,187,33,3554,3741
info_cubo_solicitudes_movilidad_OUT_v11.md,"• Preferencia Aceptada (S/N):
Permite distinguir entre aquellas preferencias de solicitudes de movilidad que han sido aceptadas (S) y las qu no (N).",paragraph,148,31,3743,3891
info_cubo_solicitudes_movilidad_OUT_v11.md,"• Programa de Movilidad:
Permite clasificar los datos en función del programa de movilidad en virtud del cual se formula la solicitud de movilidad.",paragraph,147,26,3893,4040
info_cubo_solicitudes_movilidad_OUT_v11.md,"• Renuncia (S/N):
Permite distinguir entre las solicitudes de movilidad aceptadas que no se han hecho efectivas (S) de las que s se han hecho efectivas (N).",paragraph,156,35,4042,4198
info_cubo_solicitudes_movilidad_OUT_v11.md,"• Universidad de Destino:
Permite clasificar los datos en función de la universidad para la que los estudiantes formulan la solicitud de movilidad.",paragraph,147,25,4200,4347
info_cubo_solicitudes_movilidad_OUT_v11.md,"• Universidad de Destino UNITA (S/N):
Permite clasificar los datos en función de si la universidad para la que los estudiantes formulan la solicitud de movilidad pertenece a la alianza de universidades europeas UNITA (S) o no (N).",paragraph,230,46,4349,4579
info_cubo_solicitudes_movilidad_OUT_v11.md,>El primer curso académico en que están registradas universidades UNITA es 2020/21.,paragraph,83,14,4581,4664
info_cubo_solicitudes_movilidad_OUT_v11.md,"• Área de Estudios:
Permite identificar el área de estudios o ámbito para el que se establece el acuerdo de movilidad en que se ofertan las plazas solicitadas por los estudiantes.",paragraph,179,33,4666,4845
info_cubo_solicitudes_movilidad_OUT_v11.md,## DIMENSION: Titulación ##,paragraph,27,7,4847,4874
info_cubo_solicitudes_movilidad_OUT_v11.md,"Atributos:
• Estudio:
Permite clasificar a los estudiantes en función del estudio que cursan en Unizar. Es adecuado si queremos agrupar los datos de los estudios que se imparten en varias localidades (ejemplo: ADE, Enfermería, Magisteri Medicina, etc.).",paragraph,253,49,4876,5129
info_cubo_solicitudes_movilidad_OUT_v11.md,"• Plan de Estudios:
Permite clasificar los datos en función del plan de estudios (código y denominación) cursado por los estudian en Unizar.",paragraph,140,27,5131,5271
info_cubo_solicitudes_movilidad_OUT_v11.md,"• Rama de Conocimiento:
Permite clasificar los datos en función de la Rama de Conocimiento (Artes y Humanidades, Ciencias, Ciencias Sociales y Jurídicas, Ciencias de la Salud, Ingeniería y Arquitectura) a la que pertenece el estudio cursado por estudiantes en Unizar.",paragraph,267,49,5273,5540
info_cubo_solicitudes_movilidad_OUT_v11.md,"• Tipo de Estudio:
Permite identificar el tipo de estudio cursado por los estudiantes en Unizar: grado, máster, doctorado. Con anterioridad al curso 2014/15 se muestran también licenciatura o equivalente, diplomatura o equivalent",paragraph,229,39,5542,5771
info_cubo_solicitudes_movilidad_OUT_v11.md,"=== MEDIDAS ===

** Total solicitudes **
Número total de solicitudes de movilidad presentadas por estudiantes de Unizar para realizar una estancia temporal en otra universidad, en el marco de los acuerdos bilaterales o programas de movilidad suscritos po Unizar.",sentence,262,44,0,262
info_cubo_solicitudes_movilidad_OUT_v11.md,El intercambio debe ir asociado a algún tipo de reconocimiento académico.,sentence,73,12,262,335
info_cubo_solicitudes_movilidad_OUT_v11.md,">Nota: sólo se contabilizan las solicitudes de programas de intercambio que tienen informados en SIGMA tod
los datos correspondientes a la solicitud del alumno, a la asignación de plaza y al contrato de estudios.",sentence,212,38,336,548
info_cubo_solicitudes_movilidad_OUT_v11.md,"Por tanto, se muestran datos correspondientes a los programas ERASMUS y SICUE desde el curso 2008/09, de Movilidad UE-Suiza desde el curso 2014/15, y de UZ/NOA y Movilidad Iberoamérica desde el curso 2016/17.",sentence,208,37,550,758
info_cubo_solicitudes_movilidad_OUT_v11.md,"** Total solicitudes aceptadas **
Número total de solicitudes de movilidad (ver definición de “total solicitudes”) a las que se asigna plaza.",sentence,141,29,759,900
info_cubo_solicitudes_movilidad_OUT_v11.md,"** Total renuncias **
Número total de solicitudes aceptadas que no se han hecho efectivas, ya sea por renuncia expresa o tácita.",sentence,128,26,902,1030
info_cubo_solicitudes_movilidad_OUT_v11.md,"=== DIMENSIONES ===

## DIMENSION: Alumno ##

Atributos:
• Nacionalidad:
Permite clasificar los datos en función de la nacionalidad legal de los estudiantes.",sentence,157,29,1032,1189
info_cubo_solicitudes_movilidad_OUT_v11.md,"• Rango de edad:
Permite clasificar los datos en función de los rangos de edad de los estudiantes a fecha 31 de diciembre del curso académico en que están matriculados.",sentence,168,32,1191,1359
info_cubo_solicitudes_movilidad_OUT_v11.md,">Valores posibles: 18 años o menos, 19, 20, 21, 22, 23, 24, 25, 26, 27, 28, 29, 30 a 34, 35 a 39, 40 a 44, 45 a 4
50 a 54, 55 a 59, 60 a 64, 65 años o más.",sentence,155,63,1361,1516
info_cubo_solicitudes_movilidad_OUT_v11.md,"• Residencia Familiar:
Identifica el país, la comunidad autónoma, la provincia o la población de residencia familiar informada por lo estudiantes.",sentence,146,25,1518,1664
info_cubo_solicitudes_movilidad_OUT_v11.md,"• Sexo:
Permite agrupar a los estudiantes en función de su sexo.",sentence,64,14,1666,1730
info_cubo_solicitudes_movilidad_OUT_v11.md,"## DIMENSION: CURSO ACADÉMICO ##

Notas generales:
- Clasifica los datos en función del curso académico para el que los estudiantes formulan sus solicitudes de movilidad.",sentence,170,31,1732,1902
info_cubo_solicitudes_movilidad_OUT_v11.md,>Nota: El primer curso académico del que constan datos es el 2008/09.,sentence,69,15,1904,1973
info_cubo_solicitudes_movilidad_OUT_v11.md,"## DIMENSION: Centro ##

Notas generales:
- Permite clasificar los datos en función del centro de Unizar en que los estudiantes están matriculados en el curso académico para el que formulan su solicitud de movilidad.",sentence,216,40,1975,2191
info_cubo_solicitudes_movilidad_OUT_v11.md,"## DIMENSION: Expediente ##

Atributos:
• Créditos Superados Previos:
Permite identificar los rangos de créditos superados por los estudiantes en Unizar previamente a formular su solicitud de movilidad.",sentence,202,34,2193,2395
info_cubo_solicitudes_movilidad_OUT_v11.md,">Valores posibles: 0 créditos, de 1 a 50 créditos, de 51 a 100 créditos, etc.",sentence,77,21,2397,2474
info_cubo_solicitudes_movilidad_OUT_v11.md,"• Cursos Matriculados:
Permite clasificar los datos en función del número de cursos en que se han matriculado los estudiantes en la titulación hasta el momento de formular su solicitud de movilidad.",sentence,198,34,2476,2674
info_cubo_solicitudes_movilidad_OUT_v11.md,"## DIMENSION: Fecha de actualización ##

Notas generales:
- Indica la fecha de la última recarga de datos.",sentence,106,23,2676,2782
info_cubo_solicitudes_movilidad_OUT_v11.md,Habitualmente se realiza el domingo anterior a la fecha de consulta de datos.,sentence,77,14,2784,2861
info_cubo_solicitudes_movilidad_OUT_v11.md,"## DIMENSION: Movilidad ##

Atributos:
• Idioma:
Permite clasificar los datos en función del idioma que consta en el contrato de estudios para la movilidad.",sentence,156,31,2862,3018
info_cubo_solicitudes_movilidad_OUT_v11.md,>Nota: esta dimensión solamente figura informada para movilidades efectivas del programa Erasmus.,sentence,97,15,3020,3117
info_cubo_solicitudes_movilidad_OUT_v11.md,"• Nivel de Estudios:
Permite identificar el nivel formativo de los estudiantes que solicitan la movilidad.",sentence,106,18,3119,3225
info_cubo_solicitudes_movilidad_OUT_v11.md,">Valores posibles: Undergraduate, Undergraduate/Postgraduate, Undergraduate/Doctoral,
Undergraduate/Postgraduate/Doctoral, Postgraduate, Postgraduate/Doctoral.",sentence,159,16,3227,3386
info_cubo_solicitudes_movilidad_OUT_v11.md,"• Orden de Preferencia:
Permite clasificar los datos en función del orden de preferencia consignado por los estudiantes al solicitar los destinos de la movilidad.",sentence,162,27,3388,3550
info_cubo_solicitudes_movilidad_OUT_v11.md,"• País de la Universidad de Destino:
Permite clasificar los datos en función de los países de pertenencia de las universidades de destino para las q los estudiantes solicitan la estancia.",sentence,187,33,3552,3739
info_cubo_solicitudes_movilidad_OUT_v11.md,"• Preferencia Aceptada (S/N):
Permite distinguir entre aquellas preferencias de solicitudes de movilidad que han sido aceptadas (S) y las qu no (N).",sentence,148,31,3741,3889
info_cubo_solicitudes_movilidad_OUT_v11.md,"• Programa de Movilidad:
Permite clasificar los datos en función del programa de movilidad en virtud del cual se formula la solicitud de movilidad.",sentence,147,26,3891,4038
info_cubo_solicitudes_movilidad_OUT_v11.md,"• Renuncia (S/N):
Permite distinguir entre las solicitudes de movilidad aceptadas que no se han hecho efectivas (S) de las que s se han hecho efectivas (N).",sentence,156,35,4040,4196
info_cubo_solicitudes_movilidad_OUT_v11.md,"• Universidad de Destino:
Permite clasificar los datos en función de la universidad para la que los estudiantes formulan la solicitud de movilidad.",sentence,147,25,4198,4345
info_cubo_solicitudes_movilidad_OUT_v11.md,"• Universidad de Destino UNITA (S/N):
Permite clasificar los datos en función de si la universidad para la que los estudiantes formulan la solicitud de movilidad pertenece a la alianza de universidades europeas UNITA (S) o no (N).",sentence,230,46,4347,4577
info_cubo_solicitudes_movilidad_OUT_v11.md,>El primer curso académico en que están registradas universidades UNITA es 2020/21.,sentence,83,14,4579,4662
info_cubo_solicitudes_movilidad_OUT_v11.md,"• Área de Estudios:
Permite identificar el área de estudios o ámbito para el que se establece el acuerdo de movilidad en que se ofertan las plazas solicitadas por los estudiantes.",sentence,179,33,4664,4843
info_cubo_solicitudes_movilidad_OUT_v11.md,"## DIMENSION: Titulación ##

Atributos:
• Estudio:
Permite clasificar a los estudiantes en función del estudio que cursan en Unizar.",sentence,132,26,4845,4977
info_cubo_solicitudes_movilidad_OUT_v11.md,"Es adecuado si queremos agrupar los datos de los estudios que se imparten en varias localidades (ejemplo: ADE, Enfermería, Magisteri Medicina, etc.).",sentence,149,30,4979,5128
info_cubo_solicitudes_movilidad_OUT_v11.md,"• Plan de Estudios:
Permite clasificar los datos en función del plan de estudios (código y denominación) cursado por los estudian en Unizar.",sentence,140,27,5129,5269
info_cubo_solicitudes_movilidad_OUT_v11.md,"• Rama de Conocimiento:
Permite clasificar los datos en función de la Rama de Conocimiento (Artes y Humanidades, Ciencias, Ciencias Sociales y Jurídicas, Ciencias de la Salud, Ingeniería y Arquitectura) a la que pertenece el estudio cursado por estudiantes en Unizar.",sentence,267,49,5271,5538
info_cubo_solicitudes_movilidad_OUT_v11.md,"• Tipo de Estudio:
Permite identificar el tipo de estudio cursado por los estudiantes en Unizar: grado, máster, doctorado.",sentence,122,24,5540,5662
info_cubo_solicitudes_movilidad_OUT_v11.md,"Con anterioridad al curso 2014/15 se muestran también licenciatura o equivalente, diplomatura o equivalent",sentence,106,15,5664,5770
info_cubo_test_v1.md,"# Información sobre el Cubo de Prueba

## Descripción General

Este es un documento de prueba para el sistema de RAG avanzado que integra langagent con llama-index. El cubo de prueba contiene información ficticia sobre la Universidad de Ejemplo.

## Datos Principales

La Universidad de Ejemplo cuenta con 15,000 estudiantes matriculados en el curso académico 2024-2025. De estos estudiantes, 10,000 están en programas de grado, 4,000 en programas de máster y 1,000 en programas de doctorado.

## Facultades

La universidad tiene 8 facultades principales:
- Facultad de Ciencias
- Facultad de Ingeniería
- Facultad de Medicina
- Facultad de Humanidades
- Facultad de Ciencias Sociales
- Facultad de Derecho
- Facultad de Economía y Empresa
- Facultad de Educación

## Programas Académicos

La universidad ofrece 50 programas de grado, 30 programas de máster y 15 programas de doctorado. Los programas más populares son:
- Ingeniería Informática (2,000 estudiantes)
- Medicina (1,500 estudiantes)
- Administración de Empresas (1,200 estudiantes)
- Derecho (1,000 estudiantes)
- Psicología (800 estudiantes)

## Investigación

La universidad cuenta con 25 grupos de investigación activos que trabajan en diversas áreas. En el último año, estos grupos han publicado un total de 500 artículos científicos y han obtenido financiación por valor de 10 millones de euros para proyectos de investigación.

## Movilidad Internacional

La universidad tiene acuerdos de intercambio con 100 universidades en 30 países diferentes. Cada año, 500 estudiantes participan en programas de movilidad saliente y la universidad recibe a 400 estudiantes internacionales.

## Personal

La universidad emplea a 1,200 profesores e investigadores y 800 miembros del personal de administración y servicios. El 60% del profesorado tiene el título de doctor.",section,1829,309,0,1829
info_cubo_test_v1.md,# Información sobre el Cubo de Prueba,paragraph,37,7,0,37
info_cubo_test_v1.md,## Descripción General,paragraph,22,4,39,61
info_cubo_test_v1.md,Este es un documento de prueba para el sistema de RAG avanzado que integra langagent con llama-index. El cubo de prueba contiene información ficticia sobre la Universidad de Ejemplo.,paragraph,182,31,63,245
info_cubo_test_v1.md,## Datos Principales,paragraph,20,4,247,267
info_cubo_test_v1.md,"La Universidad de Ejemplo cuenta con 15,000 estudiantes matriculados en el curso académico 2024-2025. De estos estudiantes, 10,000 están en programas de grado, 4,000 en programas de máster y 1,000 en programas de doctorado.",paragraph,223,38,269,492
info_cubo_test_v1.md,## Facultades,paragraph,13,3,494,507
info_cubo_test_v1.md,"La universidad tiene 8 facultades principales:
- Facultad de Ciencias
- Facultad de Ingeniería
- Facultad de Medicina
- Facultad de Humanidades
- Facultad de Ciencias Sociales
- Facultad de Derecho
- Facultad de Economía y Empresa
- Facultad de Educación",paragraph,254,42,509,763
info_cubo_test_v1.md,## Programas Académicos,paragraph,23,4,765,788
info_cubo_test_v1.md,"La universidad ofrece 50 programas de grado, 30 programas de máster y 15 programas de doctorado. Los programas más populares son:
- Ingeniería Informática (2,000 estudiantes)
- Medicina (1,500 estudiantes)
- Administración de Empresas (1,200 estudiantes)
- Derecho (1,000 estudiantes)
- Psicología (800 estudiantes)",paragraph,315,57,790,1105
info_cubo_test_v1.md,## Investigación,paragraph,16,3,1107,1123
info_cubo_test_v1.md,"La universidad cuenta con 25 grupos de investigación activos que trabajan en diversas áreas. En el último año, estos grupos han publicado un total de 500 artículos científicos y han obtenido financiación por valor de 10 millones de euros para proyectos de investigación.",paragraph,270,46,1125,1395
info_cubo_test_v1.md,## Movilidad Internacional,paragraph,26,4,1397,1423
info_cubo_test_v1.md,"La universidad tiene acuerdos de intercambio con 100 universidades en 30 países diferentes. Cada año, 500 estudiantes participan en programas de movilidad saliente y la universidad recibe a 400 estudiantes internacionales.",paragraph,222,34,1425,1647
info_cubo_test_v1.md,## Personal,paragraph,11,3,1649,1660
info_cubo_test_v1.md,"La universidad emplea a 1,200 profesores e investigadores y 800 miembros del personal de administración y servicios. El 60% del profesorado tiene el título de doctor.",paragraph,166,29,1662,1828
info_cubo_test_v1.md,"# Información sobre el Cubo de Prueba

## Descripción General

Este es un documento de prueba para el sistema de RAG avanzado que integra langagent con llama-index.",sentence,164,29,0,164
info_cubo_test_v1.md,El cubo de prueba contiene información ficticia sobre la Universidad de Ejemplo.,sentence,80,13,164,244
info_cubo_test_v1.md,"## Datos Principales

La Universidad de Ejemplo cuenta con 15,000 estudiantes matriculados en el curso académico 2024-2025.",sentence,123,19,245,368
info_cubo_test_v1.md,"De estos estudiantes, 10,000 están en programas de grado, 4,000 en programas de máster y 1,000 en programas de doctorado.",sentence,121,23,370,491
info_cubo_test_v1.md,"## Facultades

La universidad tiene 8 facultades principales:
- Facultad de Ciencias
- Facultad de Ingeniería
- Facultad de Medicina
- Facultad de Humanidades
- Facultad de Ciencias Sociales
- Facultad de Derecho
- Facultad de Economía y Empresa
- Facultad de Educación

## Programas Académicos

La universidad ofrece 50 programas de grado, 30 programas de máster y 15 programas de doctorado.",sentence,392,67,492,884
info_cubo_test_v1.md,"Los programas más populares son:
- Ingeniería Informática (2,000 estudiantes)
- Medicina (1,500 estudiantes)
- Administración de Empresas (1,200 estudiantes)
- Derecho (1,000 estudiantes)
- Psicología (800 estudiantes)

## Investigación

La universidad cuenta con 25 grupos de investigación activos que trabajan en diversas áreas.",sentence,330,57,886,1216
info_cubo_test_v1.md,"En el último año, estos grupos han publicado un total de 500 artículos científicos y han obtenido financiación por valor de 10 millones de euros para proyectos de investigación.",sentence,177,31,1217,1394
info_cubo_test_v1.md,"## Movilidad Internacional

La universidad tiene acuerdos de intercambio con 100 universidades en 30 países diferentes.",sentence,119,18,1395,1514
info_cubo_test_v1.md,"Cada año, 500 estudiantes participan en programas de movilidad saliente y la universidad recibe a 400 estudiantes internacionales.",sentence,130,20,1516,1646
info_cubo_test_v1.md,"## Personal

La universidad emplea a 1,200 profesores e investigadores y 800 miembros del personal de administración y servicios.",sentence,129,21,1647,1776
info_cubo_test_v1.md,El 60% del profesorado tiene el título de doctor.,sentence,49,11,1778,1827
